ארץ ישראל
[[:נחל שיאון]]	נחל שיאון
[[:הרי אדום]]	הרי אדום
[[:שער ניקנור]]	שער ניקנור
[[:סכר דגניה]]	סכר דגניה
[[:מאגר אשכול]]	מאגר אשכול
[[:בית זנדל]]	בית זנדל
[[:צריף בן-גוריון]]	צריף בן-גוריון
[[:דיג בארץ ישראל]]	דיג בארץ ישראל
[[:נחל אל על]]	נחל אל על
[[:חולות ניצנים]]	חולות ניצנים
[[:ישיבת בני עקיבא נתיב מאיר]]	ישיבת בני עקיבא נתיב מאיר
[[:הר יונה]]	הר יונה
[[:איי ראש הנקרה]]	איי ראש הנקרה
[[:ארמון הנציב]]	ארמון הנציב
[[:איי אכזיב]]	איי אכזיב
[[:הר כיתרון]]	הר כיתרון
[[:באר שמע]]	באר שמע
[[:באר אסנת]]	באר אסנת
[[:פארק ירוחם]]	פארק ירוחם
[[:הרי ירושלים]]	הרי ירושלים
[[:ורד הגליל]]	ורד הגליל
[[:ואדי מילק]]	ואדי מילק
[[:עמק חרוד]]	עמק חרוד
[[:שמורת טבע תל דן]]	שמורת טבע תל דן
[[:נחל אוג]]	נחל אוג
[[:וילקומיץ]]	וילקומיץ
[[:ארץ כינרות]]	ארץ כינרות
[[:תחנת הרכבת סמח (צמח)]]	תחנת הרכבת סמח (צמח)
[[:קטגוריה:ישראל: תכנון ובנייה]]	ישראל: תכנון ובנייה
[[:שמורת עיון]]	שמורת עיון
[[:בתי מחסה]]	בתי מחסה
[[:צומת בית דגן]]	צומת בית דגן
[[:מחלף ראשונים (גן הוורדים)]]	מחלף ראשונים (גן הוורדים)
[[:אתרים צלבניים בארץ ישראל]]	אתרים צלבניים בארץ ישראל
[[:מערות אפקה]]	מערות אפקה
[[:העיניים של המדינה]]	העיניים של המדינה
[[:קטגוריה:ארץ ישראל: חוקרי טבע]]	ארץ ישראל: חוקרי טבע
[[:חברות תעופה עבריות ביישוב]]	חברות תעופה עבריות ביישוב
[[:מישור חוף יהודה]]	מישור חוף יהודה
[[:באר אברהם]]	באר אברהם
[[:נחל ברק]]	נחל ברק
[[:ואדי מכוך]]	ואדי מכוך
[[:ואדי אל מפג'ר]]	ואדי אל מפג'ר
[[:קטגוריה:ירושלים: נחלים]]	ירושלים: נחלים
[[:המסגד הגדול ברמלה]]	המסגד הגדול ברמלה
[[:סולמה של צור]]	סולמה של צור
[[:מצפה משואה]]	מצפה משואה
[[:נחל פרס]]	נחל פרס
[[:בית המוטור]]	בית המוטור
[[:צומת רעננה]]	צומת רעננה
[[:צומת וולקן]]	צומת וולקן
[[:ואדי חרמיה]]	ואדי חרמיה
[[:תחנת הרכבת הטורקית (באר שבע)]]	תחנת הרכבת הטורקית (באר שבע)
[[:תחנת הרכבת עפולה]]	תחנת הרכבת עפולה
[[:מנהרת הטמפלרים]]	מנהרת הטמפלרים
[[:צומת השומר]]	צומת השומר
[[:צומת סביון]]	צומת סביון
[[:נחל אונו]]	נחל אונו
[[:צומח שטח]]	צומח שטח
[[:צומת הערבה]]	צומת הערבה
[[:בריכת דורה]]	בריכת דורה
[[:בריכת בנימין]]	בריכת בנימין
[[:צומת תפוח]]	צומת תפוח
[[:נחל אשכול]]	נחל אשכול
[[:תחנת הרכבת רינתיה]]	תחנת הרכבת רינתיה
[[:חורבת סמארה]]	חורבת סמארה
[[:תימני כנרת]]	תימני כנרת
[[:נחל חלילים]]	נחל חלילים
[[:תחנת הרכבת בית שאן]]	תחנת הרכבת בית שאן
