ארץ ישראל - עולם החי והצומח
[[:קטגוריה:בעלי חיים בסכנת היעלמות מארץ ישראל]]	בעלי חיים בסכנת היעלמות מארץ ישראל
[[:קטגוריה:ארץ ישראל: החי והצומח]]	ארץ ישראל: החי והצומח
[[:קטגוריה:ארץ ישראל: ציפורי שיר]]	ארץ ישראל: ציפורי שיר
[[:קטגוריה:ארץ ישראל: הדסאים]]	ארץ ישראל: הדסאים
[[:קטגוריה:ארץ ישראל: דו-פסיגיים]]	ארץ ישראל: דו-פסיגיים
[[:קטגוריה:ארץ ישראל: בעלי פרחים]]	ארץ ישראל: בעלי פרחים
[[:קטגוריה:ארץ ישראל: הצומח]]	ארץ ישראל: הצומח
[[:קטגוריה:ארץ ישראל: טחביתיים]]	ארץ ישראל: טחביתיים
[[:קטגוריה:ארץ ישראל: סרטנים עילאיים]]	ארץ ישראל: סרטנים עילאיים
[[:קטגוריה:ארץ ישראל: דו-חיים]]	ארץ ישראל: דו-חיים
[[:קטגוריה:ארץ ישראל: עצים]]	ארץ ישראל: עצים
[[:קטגוריה:ארץ ישראל: צינוראים]]	ארץ ישראל: צינוראים
[[:קטגוריה:ארץ ישראל: מחטניים]]	ארץ ישראל: מחטניים
[[:קטגוריה:ארץ ישראל: ציפורנאים]]	ארץ ישראל: ציפורנאים
[[:קטגוריה:ארץ ישראל: סלקיים]]	ארץ ישראל: סלקיים
[[:קטגוריה:ארץ ישראל: צמחים אנדמיים]]	ארץ ישראל: צמחים אנדמיים
[[:קטגוריה:ארץ ישראל: מינים אנדמיים]]	ארץ ישראל: מינים אנדמיים
[[:קטגוריה:ארץ ישראל: בעלי חיים ארסיים]]	ארץ ישראל: בעלי חיים ארסיים
[[:קטגוריה:ארץ ישראל: קשקשאים]]	ארץ ישראל: קשקשאים
[[:קטגוריה:ארץ ישראל: זוחלים]]	ארץ ישראל: זוחלים
[[:קטגוריה:ארץ ישראל: בעלי חיים שנכחדו]]	ארץ ישראל: בעלי חיים שנכחדו
[[:קטגוריה:ארץ ישראל: בקעצוריים]]	ארץ ישראל: בקעצוריים
[[:קטגוריה:ארץ ישראל: בקעצוראים]]	ארץ ישראל: בקעצוראים
[[:קטגוריה:ארץ ישראל: נאדידיים]]	ארץ ישראל: נאדידיים
[[:קטגוריה:ארץ ישראל: אדמוניתיים]]	ארץ ישראל: אדמוניתיים
[[:קטגוריה:ארץ ישראל: ורדנאים]]	ארץ ישראל: ורדנאים
[[:קטגוריה:ארץ ישראל: ציפורניים]]	ארץ ישראל: ציפורניים
[[:קטגוריה:ארץ ישראל: אורניים]]	ארץ ישראל: אורניים
[[:קטגוריה:ארץ ישראל: מחטיים]]	ארץ ישראל: מחטיים
[[:קטגוריה:ארץ ישראל: ברושיים]]	ארץ ישראל: ברושיים
[[:קטגוריה:ארץ ישראל: הדסיים]]	ארץ ישראל: הדסיים
[[:קטגוריה:ארץ ישראל: זיתיים]]	ארץ ישראל: זיתיים
[[:קטגוריה:ארץ ישראל: טבוריתיים]]	ארץ ישראל: טבוריתיים
[[:קטגוריה:ארץ ישראל: אלף העלה]]	ארץ ישראל: אלף העלה
[[:קטגוריה:ארץ ישראל: ורדיים]]	ארץ ישראל: ורדיים
[[:קטגוריה:ארץ ישראל: צבריים]]	ארץ ישראל: צבריים
[[:קטגוריה:ארץ ישראל: פעמוניתיים]]	ארץ ישראל: פעמוניתיים
[[:קטגוריה:ארץ ישראל: אסטראים]]	ארץ ישראל: אסטראים
[[:קטגוריה:ארץ ישראל: פיגמיים]]	ארץ ישראל: פיגמיים
[[:קטגוריה:ארץ ישראל: סבוננאים]]	ארץ ישראל: סבוננאים
[[:קטגוריה:ארץ ישראל: אלתיים]]	ארץ ישראל: אלתיים
[[:קטגוריה:ארץ ישראל: אזדרכתיים]]	ארץ ישראל: אזדרכתיים
[[:קטגוריה:ארץ ישראל: אשחריים]]	ארץ ישראל: אשחריים
[[:קטגוריה:ארץ ישראל: הרדופיים]]	ארץ ישראל: הרדופיים
[[:קטגוריה:ארץ ישראל: גנציינאים]]	ארץ ישראל: גנציינאים
[[:קטגוריה:ארץ ישראל: יערתיים]]	ארץ ישראל: יערתיים
[[:קטגוריה:ארץ ישראל: שלמונאים]]	ארץ ישראל: שלמונאים
[[:קטגוריה:ארץ ישראל: מתנניים]]	ארץ ישראל: מתנניים
[[:קטגוריה:ארץ ישראל: חלמיתאים]]	ארץ ישראל: חלמיתאים
[[:קטגוריה:ארץ ישראל: אברשאים]]	ארץ ישראל: אברשאים
[[:קטגוריה:ארץ ישראל: נרקיסיים]]	ארץ ישראל: נרקיסיים
[[:קטגוריה:ארץ ישראל: אספרגאים]]	ארץ ישראל: אספרגאים
[[:קטגוריה:ארץ ישראל: חד פסיגיים]]	ארץ ישראל: חד פסיגיים
[[:קטגוריה:ארץ ישראל: דגנאים]]	ארץ ישראל: דגנאים
[[:קטגוריה:ארץ ישראל: דקלאים]]	ארץ ישראל: דקלאים
[[:קטגוריה:ארץ ישראל: כף הצפרדע]]	ארץ ישראל: כף הצפרדע
[[:קטגוריה:ארץ ישראל: בוציציים]]	ארץ ישראל: בוציציים
[[:קטגוריה:ארץ ישראל: סחלביים]]	ארץ ישראל: סחלביים
[[:קטגוריה:ארץ ישראל: אספרגיים]]	ארץ ישראל: אספרגיים
[[:קטגוריה:ארץ ישראל: סתווניים]]	ארץ ישראל: סתווניים
[[:קטגוריה:ארץ ישראל: שושנאים]]	ארץ ישראל: שושנאים
[[:קטגוריה:ארץ ישראל: שושניים]]	ארץ ישראל: שושניים
[[:בריכת דורה]]	בריכת דורה
[[:שמורת תנוריה]]	שמורת תנוריה
[[:קטגוריה:ארץ ישראל: שווה-רגלאים]]	ארץ ישראל: שווה-רגלאים
[[:קטגוריה:ארץ ישראל: פרוקי-רגליים]]	ארץ ישראל: פרוקי-רגליים
