ארון הספרים היהודי
[[:נפש החיים]]	נפש החיים
[[:תנורו של עכנאי]]	תנורו של עכנאי
[[:הקדמות הרמב"ם]]	הקדמות הרמב"ם
[[:השועל והכרם]]	השועל והכרם
[[:נאה דורש נאה מקיים]]	נאה דורש נאה מקיים
[[:אש קודש]]	אש קודש
[[:סיפורי מעשיות משנים קדמוניות]]	סיפורי מעשיות משנים קדמוניות
[[:תפארת ישראל (מהר"ל)]]	תפארת ישראל (מהר"ל)
[[:מצודות]]	מצודות
[[:מאורות הדף היומי]]	מאורות הדף היומי
[[:קטגוריה:תרי"ג מצוות]]	תרי"ג מצוות
[[:מקראות גדולות הכתר]]	מקראות גדולות הכתר
[[:דפוס סלאוויטא]]	דפוס סלאוויטא
[[:ליקוטי הלכות]]	ליקוטי הלכות
[[:ליקוטי עצות]]	ליקוטי עצות
[[:ליקוטי תפילות]]	ליקוטי תפילות
[[:טבי]]	טבי
[[:אדר היקר]]	אדר היקר
[[:ישראל מזמושץ']]	ישראל מזמושץ'
[[:משה כהן שאולי]]	משה כהן שאולי
[[:ישראל קושטא]]	ישראל קושטא
[[:משה רבקש]]	משה רבקש
[[:אוצר פירושים וציורים להגדה של פסח]]	אוצר פירושים וציורים להגדה של פסח
[[:דוד בן עמרם עדני]]	דוד בן עמרם עדני
[[:יהודה רצהבי]]	יהודה רצהבי
[[:ספר הקנה]]	ספר הקנה
[[:הגדה קיבוצית לפסח]]	הגדה קיבוצית לפסח
[[:ברוך הגבר]]	ברוך הגבר
[[:צפנת פענח (על הרמב"ם)]]	צפנת פענח (על הרמב"ם)
[[:הגדת רוטשילד]]	הגדת רוטשילד
