ארץ ישראל - היסטוריה
[[:שמש-אדום]]	שמש-אדום
[[:חשבו]]	חשבו
[[:התקופה ההלניסטית בארץ ישראל]]	התקופה ההלניסטית בארץ ישראל
[[:התקופה הפרסית בארץ ישראל]]	התקופה הפרסית בארץ ישראל
[[:יהושע מאיר גרינץ]]	יהושע מאיר גרינץ
[[:אתרים צלבניים בארץ ישראל]]	אתרים צלבניים בארץ ישראל
[[:מקדשי ממלכת ישראל]]	מקדשי ממלכת ישראל
[[:קלר אפשטין]]	קלר אפשטין
[[:יוסף אהרונוביץ']]	יוסף אהרונוביץ'
[[:טור מלכא]]	טור מלכא
[[:יהושע בן אריה]]	יהושע בן אריה
[[:נויהרדטהוף]]	נויהרדטהוף
[[:ואדי חרמיה]]	ואדי חרמיה
[[:מרדכי סלומון]]	מרדכי סלומון
[[:מנהרת הטמפלרים]]	מנהרת הטמפלרים
[[:מקובלי צפת]]	מקובלי צפת
&rlm;[[:יהודים בירושלים במאה ה-15 וה-16]]&rlm;	יהודים בירושלים במאה ה-15 וה-16
[[:התיישבות נתיני המעצמות בחיפה]]	התיישבות נתיני המעצמות בחיפה
[[:אבוקה (קיבוץ)]]	אבוקה (קיבוץ)
[[:תמונת מתקפת הפרשים בקרב באר שבע]]	תמונת מתקפת הפרשים בקרב באר שבע
