בעלי חיים
[[:בעלי חיים שנעלמו מארץ ישראל]]	בעלי חיים שנעלמו מארץ ישראל
[[:זימרגל ארץ ישראלי]]	זימרגל ארץ ישראלי
[[:צבי ארץ ישראלי]]	צבי ארץ ישראלי
[[:נחושתית הקוצים]]	נחושתית הקוצים
[[:רצה מצוירת]]	רצה מצוירת
[[:עינפז רקום-כנף]]	עינפז רקום-כנף
[[:זעמן זיתני]]	זעמן זיתני
[[:זעמן מטבעות]]	זעמן מטבעות
[[:עביד צהוב]]	עביד צהוב
[[:שממית עצים]]	שממית עצים
[[:עביד שחום]]	עביד שחום
[[:שיחן שכיח]]	שיחן שכיח
[[:אקלמפסיה (כלבות)]]	אקלמפסיה (כלבות)
[[:חפרית מצויה]]	חפרית מצויה
[[:קטגוריה:סרטנים עילאיים]]	סרטנים עילאיים
[[:ישימונית דו-גונית]]	ישימונית דו-גונית
[[:נמלת קציר חולית]]	נמלת קציר חולית
[[:רצען מנומר]]	רצען מנומר
[[:כושן ארסי]]	כושן ארסי
[[:שנונית הנחלים]]	שנונית הנחלים
[[:אורגת האשלים]]	אורגת האשלים
[[:תריסית הצלף]]	תריסית הצלף
[[:ציידת השבלולים]]	ציידת השבלולים
[[:נבו יריחו]]	נבו יריחו
[[:חרדון צב הדור]]	חרדון צב הדור
