גאולוגיה
[[:מצוק ההעתקים]]	מצוק ההעתקים
[[:תחום אי רציפות]]	תחום אי רציפות
[[:טרשים]]	טרשים
[[:פארק הסלעים]]	פארק הסלעים
[[:עקיבא פלכסר]]	עקיבא פלכסר
[[:מחצבות הגופרית בארי]]	מחצבות הגופרית בארי
[[:הקניון האדום]]	הקניון האדום
[[:קו התלים הישראלי]]	קו התלים הישראלי
[[:אקוויפר ההר]]	אקוויפר ההר
[[:אקוויפר החרמון]]	אקוויפר החרמון
[[:אקוויפר החוף]]	אקוויפר החוף
[[:עמנואל מזור]]	עמנואל מזור
[[:המכון הגיאולוגי לישראל]]	המכון הגיאולוגי לישראל
[[:חבורת יהודה]]	חבורת יהודה
[[:חבורת עבדת]]	חבורת עבדת
[[:חמאם אל-מליח]]	חמאם אל-מליח
[[:הלוח הלבנטיני]]	הלוח הלבנטיני
[[:שקע הבזלת של דלתון]]	שקע הבזלת של דלתון
[[:טבלת גידוד]]	טבלת גידוד
[[:קניון באר שבע-עזה]]	קניון באר שבע-עזה
[[:אגם עובדיה]]	אגם עובדיה
[[:זיהוי סלעים]]	זיהוי סלעים
[[:זיהוי מינרלים]]	זיהוי מינרלים
[[:בורג' אל-מלח]]	בורג' אל-מלח
[[:תצורת צרעה]]	תצורת צרעה
[[:תצורת מוצא]]	תצורת מוצא
[[:גאולוגיה של ישראל]]	גאולוגיה של ישראל
[[:חבורת ים המלח]]	חבורת ים המלח
[[:תצורת הבזלת התיכונה]]	תצורת הבזלת התיכונה
[[:חבורת הר הצופים]]	חבורת הר הצופים
[[:קרן עין גב]]	קרן עין גב
[[:חבורת ערד]]	חבורת ערד
[[:חבורת סקיה]]	חבורת סקיה
[[:תצורת בענה]]	תצורת בענה
[[:חבורת כורכר]]	חבורת כורכר
[[:תצורת מאליח]]	תצורת מאליח
[[:תצורת הלשון]]	תצורת הלשון
[[:תצורת חפר]]	תצורת חפר
[[:הקשת הסורית]]	הקשת הסורית
[[:גאולוגיה של הגולן]]	גאולוגיה של הגולן
[[:תצורת גולן]]	תצורת גולן
[[:חבורת הבשן]]	חבורת הבשן
[[:המכון למדעי כדור הארץ]]	המכון למדעי כדור הארץ
[[:תצורת מוחילה]]	תצורת מוחילה
[[:גבעת טליה]]	גבעת טליה
[[:תצורת שורק]]	תצורת שורק
[[:נתן שלם]]	נתן שלם
[[:דוד ניב (גאולוג)]]	דוד ניב (גאולוג)
[[:מחצבות חפציבה]]	מחצבות חפציבה
[[:צבי בן-אברהם]]	צבי בן-אברהם
[[:יוסי לנגוצקי]]	יוסי לנגוצקי
[[:צבי גרפונקל]]	צבי גרפונקל
[[:מדבר שומרון]]	מדבר שומרון
[[:יהושע קולודני]]	יהושע קולודני
[[:ארי בן מנחם]]	ארי בן מנחם
[[:אמוץ עגנון]]	אמוץ עגנון
[[:מינרל יוצר סלע]]	מינרל יוצר סלע
[[:גאולוגיה של הכרמל]]	גאולוגיה של הכרמל
[[:האורוגנזה הקיבארית]]	האורוגנזה הקיבארית
[[:האורוגנזה החיג'אזית]]	האורוגנזה החיג'אזית
[[:סמסונס ריבס]]	סמסונס ריבס
[[:איזור (גאולוגיה)]]	איזור (גאולוגיה)
[[:מבנה (גאולוגיה)]]	מבנה (גאולוגיה)
