היסטוריה
&rlm;[[:אירלנד בשנות ה-90 של המאה ה-20 ואילך]]&rlm;	אירלנד בשנות ה-90 של המאה ה-20 ואילך
[[:ארנון גוטפלד]]	ארנון גוטפלד
[[:טורמנטום]]	טורמנטום
[[:פלביסקיטום]]	פלביסקיטום
[[:וירונרים]]	וירונרים
[[:סביל]]	סביל
[[:תרבות הגוף ביוון העתיקה]]	תרבות הגוף ביוון העתיקה
[[:ישראל שצמן]]	ישראל שצמן
[[:אתרים צלבניים בארץ ישראל]]	אתרים צלבניים בארץ ישראל
[[:קטגוריה:האימפריה הרוסית: היסטוריה]]	האימפריה הרוסית: היסטוריה
[[:היסטוריה של אתונה בימי יוון העתיקה]]	היסטוריה של אתונה בימי יוון העתיקה
&rlm;[[:קטגוריה:המאה ה-1 לפנה"ס לפי שנים]]&rlm;	המאה ה-1 לפנה"ס לפי שנים
&rlm;[[:קטגוריה:המאה ה-2 לפנה"ס לפי שנים]]&rlm;	המאה ה-2 לפנה"ס לפי שנים
&rlm;[[:קטגוריה:המאה ה-3 לפנה"ס לפי שנים]]&rlm;	המאה ה-3 לפנה"ס לפי שנים
&rlm;[[:קטגוריה:המאה ה-4 לפנה"ס לפי שנים]]&rlm;	המאה ה-4 לפנה"ס לפי שנים
&rlm;[[:קטגוריה:המאה ה-5 לפנה"ס לפי שנים]]&rlm;	המאה ה-5 לפנה"ס לפי שנים
[[:תקופת התחייה]]	תקופת התחייה
[[:דוד בן דוד]]	דוד בן דוד
[[:יוסף דרורי]]	יוסף דרורי
[[:הזירה הימית במלחמה הפונית השנייה]]	הזירה הימית במלחמה הפונית השנייה
[[:קטגוריה:גאורגיה בתקופת האימפריה הרוסית]]	גאורגיה בתקופת האימפריה הרוסית
[[:וסלי ליבלר]]	וסלי ליבלר
[[:דן מכמן]]	דן מכמן
[[:סין המיתולוגית]]	סין המיתולוגית
[[:שדרה חברתית]]	שדרה חברתית
[[:עבד-אל-מונעם אבו בכר]]	עבד-אל-מונעם אבו בכר
