היישוב
[[:ארגונים צבאיים לפני קום המדינה]]	ארגונים צבאיים לפני קום המדינה
[[:אברהם איכר]]	אברהם איכר
[[:טוביה קושניר]]	טוביה קושניר
[[:שמחה אסף]]	שמחה אסף
[[:אחוזת בית]]	אחוזת בית
[[:מיכאל הלפרן]]	מיכאל הלפרן
[[:חיים בסוק]]	חיים בסוק
[[:שמואל קופמן]]	שמואל קופמן
[[:טורים]]	טורים
[[:חברה לשירות ימי עתיד]]	חברה לשירות ימי עתיד
[[:ישיבת תורת חיים]]	ישיבת תורת חיים
[[:החבל הימי לישראל]]	החבל הימי לישראל
[[:ארתור מנחם הנטקה]]	ארתור מנחם הנטקה
[[:הרן בר דור]]	הרן בר דור
[[:טובה פירון]]	טובה פירון
[[:חוות כנרת]]	חוות כנרת
[[:אריה שנארי]]	אריה שנארי
[[:שמואל אהרנסון]]	שמואל אהרנסון
[[:סיגריות מספרו]]	סיגריות מספרו
[[:רבקה אהרנסון]]	רבקה אהרנסון
[[:שמעון רוקח]]	שמעון רוקח
[[:דוד ילין]]	דוד ילין
[[:הלל דן]]	הלל דן
[[:יחזקאל חנקין]]	יחזקאל חנקין
[[:ישראל גלעדי]]	ישראל גלעדי
[[:יהושע ברנדשטטר]]	יהושע ברנדשטטר
[[:רענן ויץ]]	רענן ויץ
[[:קלר אפשטין]]	קלר אפשטין
[[:ראובן מס]]	ראובן מס
[[:קטגוריה:אנשי העלייה השנייה]]	אנשי העלייה השנייה
[[:שמואל צבי הולצמן]]	שמואל צבי הולצמן
[[:סוניה קולודני]]	סוניה קולודני
[[:אלעזר רוקח]]	אלעזר רוקח
[[:יוסף אהרונוביץ']]	יוסף אהרונוביץ'
[[:יהושע בן אריה]]	יהושע בן אריה
[[:דוד שוב]]	דוד שוב
[[:קטגוריה:אנשי העלייה הראשונה]]	אנשי העלייה הראשונה
[[:קטגוריה:אנשי העלייה השלישית]]	אנשי העלייה השלישית
[[:קטגוריה:אנשי העלייה הרביעית]]	אנשי העלייה הרביעית
[[:קטגוריה:אנשי העלייה החמישית]]	אנשי העלייה החמישית
[[:גבריאל צפרוני]]	גבריאל צפרוני
[[:דב פטישי]]	דב פטישי
[[:אליעזר מרגולין]]	אליעזר מרגולין
[[:אהרן שלוש]]	אהרן שלוש
[[:ישראל קלוזנר]]	ישראל קלוזנר
[[:יעקב סיקא אהרוני]]	יעקב סיקא אהרוני
[[:ישראל פורת]]	ישראל פורת
[[:ישראל ב"ק]]	ישראל ב"ק
[[:שמעון שרון]]	שמעון שרון
[[:יהודה צלליכין]]	יהודה צלליכין
[[:קטגוריה:אנשי היישוב ילידי הארץ]]	אנשי היישוב ילידי הארץ
[[:קטגוריה:אנשי היישוב הוותיק ילידי ארץ ישראל]]	אנשי היישוב הוותיק ילידי ארץ ישראל
[[:ישראל עמיקם]]	ישראל עמיקם
[[:שמחה גולן]]	שמחה גולן
&rlm;[[:Visit Palestine]]&rlm;	Visit Palestine
[[:רוזה כהן]]	רוזה כהן
[[:גדוד טוביה]]	גדוד טוביה
[[:בריכת בנימין]]	בריכת בנימין
[[:יצחק גולן (עיתונאי)]]	יצחק גולן (עיתונאי)
[[:יעל פוזנר]]	יעל פוזנר
&rlm;[[:יום חמישי השחור, 1914]]&rlm;	יום חמישי השחור, 1914
[[:מאיר גורביץ]]	מאיר גורביץ
[[:צי עברי]]	צי עברי
[[:החברה לאסדות וספנות חופית]]	החברה לאסדות וספנות חופית
[[:חופיה]]	חופיה
[[:יהודה גור]]	יהודה גור
[[:קטגוריה:ימאות ביישוב]]	ימאות ביישוב
[[:קטגוריה:ימאי היישוב]]	ימאי היישוב
[[:תימני כנרת]]	תימני כנרת
[[:חלוץ (אונייה)]]	חלוץ (אונייה)
[[:שירות ימי ארץ ישראלי]]	שירות ימי ארץ ישראלי
[[:הר ציון (אונייה)]]	הר ציון (אונייה)
[[:הלויד הימי הארץ ישראלי]]	הלויד הימי הארץ ישראלי
[[:הר כרמל (אונייה)]]	הר כרמל (אונייה)
[[:מילוס (אוניית מעפילים)]]	מילוס (אוניית מעפילים)
[[:נחשון (חברת דיג)]]	נחשון (חברת דיג)
[[:קטגוריה:כלי שיט בתקופת היישוב]]	כלי שיט בתקופת היישוב
[[:ועדת המים]]	ועדת המים
[[:ההתקפה על המרכז המסחרי בממילא]]	ההתקפה על המרכז המסחרי בממילא
[[:ישראל פיינברג]]	ישראל פיינברג
[[:הגרלת המגרשים לאחוזת בית]]	הגרלת המגרשים לאחוזת בית
[[:אהרן מאיר מזי"א]]	אהרן מאיר מזי"א
[[:יהודה אריה לוי]]	יהודה אריה לוי
[[:פעולת האצ"ל בעיראק]]	פעולת האצ"ל בעיראק
[[:ורה דוכס]]	ורה דוכס
[[:רפאל מהודר]]	רפאל מהודר
[[:נחמיה רבין]]	נחמיה רבין
