הלכה
[[:תקנת השבים]]	תקנת השבים
[[:תנורו של עכנאי]]	תנורו של עכנאי
[[:איסורי נישואים לכהן]]	איסורי נישואים לכהן
[[:הכשרת בשר]]	הכשרת בשר
[[:הבא במחתרת]]	הבא במחתרת
[[:אב הטומאה]]	אב הטומאה
[[:תחום שבת]]	תחום שבת
[[:טובל ושרץ בידו]]	טובל ושרץ בידו
[[:תערובת (הלכה)]]	תערובת (הלכה)
[[:פסק דין האח והאחות]]	פסק דין האח והאחות
[[:קטב מרירי]]	קטב מרירי
[[:תארים רבניים]]	תארים רבניים
[[:שמיטת כספים]]	שמיטת כספים
[[:קטגוריה:תרי"ג מצוות]]	תרי"ג מצוות
[[:דבר שאינו מתכוון]]	דבר שאינו מתכוון
[[:חומרא דרבי זירא]]	חומרא דרבי זירא
[[:אשמורות הלילה]]	אשמורות הלילה
[[:קריאת הגבר]]	קריאת הגבר
[[:יעלה ויבוא]]	יעלה ויבוא
[[:איסורי כישוף ביהדות]]	איסורי כישוף ביהדות
[[:מיאון]]	מיאון
[[:נותר]]	נותר
[[:דבר שלא בא לעולם]]	דבר שלא בא לעולם
[[:טומאת ידיים]]	טומאת ידיים
[[:מסיבה (בית המקדש)]]	מסיבה (בית המקדש)
[[:דיו לנצח]]	דיו לנצח
[[:צמצום (הלכה)]]	צמצום (הלכה)
[[:תפילת בית המדרש]]	תפילת בית המדרש
[[:כתם (נידה)]]	כתם (נידה)
[[:טב למיתב טן דו מלמיתב ארמלו]]	טב למיתב טן דו מלמיתב ארמלו
