השואה
[[:אנטישמיות בגרמניה]]	אנטישמיות בגרמניה
[[:בורות הריגה]]	בורות הריגה
[[:איגרת הבזק של היידריך]]	איגרת הבזק של היידריך
[[:חיים בסוק]]	חיים בסוק
[[:קטגוריה:יהודים בשואה]]	יהודים בשואה
[[:ספר עדות]]	ספר עדות
[[:יעקב קורץ]]	יעקב קורץ
[[:אש קודש]]	אש קודש
[[:משה הופמן]]	משה הופמן
[[:תבליט השואה והגבורה]]	תבליט השואה והגבורה
[[:טטיאנה זלנסקיה]]	טטיאנה זלנסקיה
[[:קטגוריה:יודנראט]]	יודנראט
[[:לסביות בגרמניה הנאצית]]	לסביות בגרמניה הנאצית
[[:קטגוריה:קצרמר השואה]]	קצרמר השואה
[[:ניסויי מנגלה בתאומים]]	ניסויי מנגלה בתאומים
[[:מסע בני נוער לפולין]]	מסע בני נוער לפולין
[[:אדלאיד הובאל]]	אדלאיד הובאל
[[:אברהם אלטר פולק]]	אברהם אלטר פולק
[[:אברהם אלימלך פרלוב]]	אברהם אלימלך פרלוב
[[:מירצ'ה פטרו סיון]]	מירצ'ה פטרו סיון
[[:וולפגנג הופמן]]	וולפגנג הופמן
[[:שואת יהודי צפון טרנסילבניה]]	שואת יהודי צפון טרנסילבניה
[[:הוועד הארצי של ארגוני נוער יהודיים]]	הוועד הארצי של ארגוני נוער יהודיים
[[:יציאת האדמו"ר מבעלז מהונגריה]]	יציאת האדמו"ר מבעלז מהונגריה
[[:טבח סרמאשו]]	טבח סרמאשו
[[:קטגוריה:רבנים בשואה]]	רבנים בשואה
[[:מרתף השואה]]	מרתף השואה
[[:טוביה רביב]]	טוביה רביב
[[:אפליית יהודים בהולנד לאחר מלחמת העולם השנייה]]	אפליית יהודים בהולנד לאחר מלחמת העולם השנייה
[[:קטגוריה:ספורטאים יהודים בשואה]]	ספורטאים יהודים בשואה
[[:קטגוריה:שחמטאים יהודים בשואה]]	שחמטאים יהודים בשואה
[[:התשעים ושלוש]]	התשעים ושלוש
