יהדות
[[:בגדי שבת]]	בגדי שבת
[[:תנורו של עכנאי]]	תנורו של עכנאי
[[:ברכת האילנות]]	ברכת האילנות
[[:תולדות יעקב יוסף]]	תולדות יעקב יוסף
[[:מסכת טהרות]]	מסכת טהרות
[[:מסכת זבים]]	מסכת זבים
[[:מסכת טבול יום]]	מסכת טבול יום
[[:מסכת ידיים]]	מסכת ידיים
[[:ברכות הנהנין]]	ברכות הנהנין
[[:היתר מכירה]]	היתר מכירה
[[:תיקון ליל שבועות]]	תיקון ליל שבועות
[[:קורבן התמיד]]	קורבן התמיד
[[:תוספת שבת]]	תוספת שבת
[[:אברך]]	אברך
[[:ברכות התורה]]	ברכות התורה
[[:תיקון המידות]]	תיקון המידות
[[:תפילת שבע]]	תפילת שבע
[[:ברכת גבורות]]	ברכת גבורות
[[:ברכת ההודאה]]	ברכת ההודאה
[[:תארים רבניים]]	תארים רבניים
[[:פיטום הקטורת]]	פיטום הקטורת
[[:מלכויות זכרונות ושופרות]]	מלכויות זכרונות ושופרות
[[:נוסח צרפת]]	נוסח צרפת
[[:נוסח צה"ל האחיד]]	נוסח צה"ל האחיד
[[:שקיעת החמה]]	שקיעת החמה
[[:בחדרי חרדים]]	בחדרי חרדים
[[:ראש מילין]]	ראש מילין
[[:הפילוסופיה הרביעית]]	הפילוסופיה הרביעית
[[:איזדדואר]]	איזדדואר
[[:שבתי (שם פרטי)]]	שבתי (שם פרטי)
[[:חסידות סרט ויז'ניץ]]	חסידות סרט ויז'ניץ
[[:דרשו ד' ועוזו]]	דרשו ד' ועוזו
[[:מעט מן האור]]	מעט מן האור
[[:קטגוריה:תרי"ג מצוות]]	תרי"ג מצוות
[[:ישיבת שערי יושר (ירושלים)]]	ישיבת שערי יושר (ירושלים)
[[:דרשנות]]	דרשנות
[[:סיפור יציאת מצרים]]	סיפור יציאת מצרים
[[:רב פורים]]	רב פורים
[[:קטגוריה:יהדות הבלקן]]	יהדות הבלקן
[[:מכת בכורות]]	מכת בכורות
[[:ישיבת הסדר חולון]]	ישיבת הסדר חולון
[[:פלגינן דיבורא]]	פלגינן דיבורא
[[:קורבן תודה]]	קורבן תודה
[[:פטר חמור]]	פטר חמור
[[:תורת השמיטות]]	תורת השמיטות
[[:ברכות קריאת שמע]]	ברכות קריאת שמע
[[:לחם משנה]]	לחם משנה
[[:עזרת נשים (בית המקדש)]]	עזרת נשים (בית המקדש)
[[:ספרייה תורנית]]	ספרייה תורנית
[[:שלמי חגיגה]]	שלמי חגיגה
[[:קורבן מוסף]]	קורבן מוסף
[[:קורבן מנחה]]	קורבן מנחה
[[:משכן נוב]]	משכן נוב
[[:משכן גבעון]]	משכן גבעון
[[:משכן גלגל]]	משכן גלגל
[[:קורבן שלמים]]	קורבן שלמים
[[:זיהוי מקום המקדש]]	זיהוי מקום המקדש
[[:אמנת גביזון-מדן]]	אמנת גביזון-מדן
[[:ברכת הבנים]]	ברכת הבנים
[[:אתר הניווט בתנ"ך]]	אתר הניווט בתנ"ך
[[:מיסטיקה יהודית]]	מיסטיקה יהודית
[[:ישיבת חברותא]]	ישיבת חברותא
[[:קטגוריה:יהדות אמריקה הלטינית]]	יהדות אמריקה הלטינית
[[:הסכם יששכר וזבולון]]	הסכם יששכר וזבולון
[[:ישיבת עטרת ישראל]]	ישיבת עטרת ישראל
[[:מכון שבות עם]]	מכון שבות עם
[[:מכללה ירושלים]]	מכללה ירושלים
[[:הא לחמא עניא]]	הא לחמא עניא
[[:יום חול]]	יום חול
[[:פיגול]]	פיגול
[[:אולפנת הרב בהר"ן]]	אולפנת הרב בהר"ן
[[:קטגוריה:יהדות פרובנס]]	יהדות פרובנס
[[:קטגוריה:יהדות מזרח אירופה]]	יהדות מזרח אירופה
[[:נוסח לא-אורתודוקסי]]	נוסח לא-אורתודוקסי
[[:דיו לנצח]]	דיו לנצח
[[:תענית בה"ב]]	תענית בה"ב
[[:קטגוריה:ספרות הגאונים]]	ספרות הגאונים
[[:קטגוריה:יהודים מטרנסילבניה]]	יהודים מטרנסילבניה
[[:קטגוריה:יהודים שעוטרו במדליית הכבוד]]	יהודים שעוטרו במדליית הכבוד
[[:קטגוריה:יהודים ממונקאץ]]	יהודים ממונקאץ
[[:קניין חליפין]]	קניין חליפין
[[:קטגוריה:צנזורה ביהדות]]	צנזורה ביהדות
[[:חיים ליברמן]]	חיים ליברמן
[[:עולת ראייה]]	עולת ראייה
[[:שלמי שמחה]]	שלמי שמחה
[[:קללת עזרא הסופר]]	קללת עזרא הסופר
[[:פולמוס השבת ביפן]]	פולמוס השבת ביפן
[[:כוונה (יהדות)]]	כוונה (יהדות)
[[:מלאכת מעבד]]	מלאכת מעבד
[[:מלאכות בונה וסותר]]	מלאכות בונה וסותר
[[:תפיסה (משפט עברי)]]	תפיסה (משפט עברי)
[[:רחיצה בשבת]]	רחיצה בשבת
[[:מכת חושך]]	מכת חושך
[[:נהרדעא (ישיבה תיכונית)]]	נהרדעא (ישיבה תיכונית)
