יהודים בתפוצות
[[:שמואל בן פלטיאל]]	שמואל בן פלטיאל
[[:שמואל ברסלב]]	שמואל ברסלב
[[:באבאי בן לוטף]]	באבאי בן לוטף
[[:באבאי בן פרהאד]]	באבאי בן פרהאד
[[:אורפלים]]	אורפלים
[[:נאש דידן]]	נאש דידן
[[:מבצע יכין]]	מבצע יכין
[[:עיתונות ציונית ברומניה]]	עיתונות ציונית ברומניה
[[:שמואל גלזרמן]]	שמואל גלזרמן
[[:בלאו וייס]]	בלאו וייס
[[:בוריס קלצקין]]	בוריס קלצקין
[[:שניאור וסרמן]]	שניאור וסרמן
[[:הלל זלטופולסקי]]	הלל זלטופולסקי
[[:אריה (לאון) סימון]]	אריה (לאון) סימון
[[:פרשת שמעון אבלס]]	פרשת שמעון אבלס
[[:ברוך לינדא]]	ברוך לינדא
[[:סטיוארט פרקוף]]	סטיוארט פרקוף
[[:אה"ו]]	אה"ו
[[:ישיבת שער התורה]]	ישיבת שער התורה
[[:משה אנסהיים]]	משה אנסהיים
[[:משכילים מוקדמים]]	משכילים מוקדמים
[[:קטגוריה:משכילים מוקדמים]]	משכילים מוקדמים
[[:הוועד הארצי של ארגוני נוער יהודיים]]	הוועד הארצי של ארגוני נוער יהודיים
[[:טוץ']]	טוץ'
[[:יוליה סוארה]]	יוליה סוארה
[[:מרצ'ל ברסלשו]]	מרצ'ל ברסלשו
[[:גראנה (תוניסיה)]]	גראנה (תוניסיה)
[[:קטגוריה:יהודים יוגוסלבים]]	יהודים יוגוסלבים
[[:אברהם יוזפוביץ]]	אברהם יוזפוביץ
[[:קול ברלין]]	קול ברלין
[[:מאיר פוזנר]]	מאיר פוזנר
[[:יהדות סצ'חרה]]	יהדות סצ'חרה
[[:יהדות סוחומי]]	יהדות סוחומי
[[:שול קולט]]	שול קולט
[[:דוד גורדון]]	דוד גורדון
[[:פאביוס שך]]	פאביוס שך
[[:הקהילה היהודית במרגיטה]]	הקהילה היהודית במרגיטה
