ירושלים
[[:משה וולך]]	משה וולך
[[:ישיבת תורת חיים]]	ישיבת תורת חיים
[[:ארמון הנציב]]	ארמון הנציב
[[:תערוכות מגדל דוד]]	תערוכות מגדל דוד
[[:מסגד סידנא עומר]]	מסגד סידנא עומר
[[:שאלו שלום ירושלם ישליו אהביך]]	שאלו שלום ירושלם ישליו אהביך
[[:אכסניית קאזה נובה (ירושלים)]]	אכסניית קאזה נובה (ירושלים)
[[:בית הספר התיכון על שם מיי בויאר]]	בית הספר התיכון על שם מיי בויאר
[[:תבליט השואה והגבורה]]	תבליט השואה והגבורה
[[:קטגוריה:ירושלים: ישיבות תיכוניות]]	ירושלים: ישיבות תיכוניות
[[:קטגוריה:ירושלים: פסלים]]	ירושלים: פסלים
[[:מחווה לירושלים]]	מחווה לירושלים
[[:עזרת נשים (בית המקדש)]]	עזרת נשים (בית המקדש)
[[:קטגוריה:ירושלים: המושבה הגרמנית]]	ירושלים: המושבה הגרמנית
[[:קטגוריה:ירושלים: נחלים]]	ירושלים: נחלים
[[:נחלת שמעון]]	נחלת שמעון
[[:תוכנית ספדיה]]	תוכנית ספדיה
[[:שכונת חצר]]	שכונת חצר
[[:שוק העיר העתיקה בירושלים]]	שוק העיר העתיקה בירושלים
[[:אהל משה]]	אהל משה
[[:מרתף השואה]]	מרתף השואה
[[:שדרות הרצל]]	שדרות הרצל
[[:שכונות הגנים בירושלים]]	שכונות הגנים בירושלים
[[:סיבוב השערים]]	סיבוב השערים
[[:גן אליעזר ילין]]	גן אליעזר ילין
[[:קטגוריה:בית וגן]]	בית וגן
[[:צומת האיקסים]]	צומת האיקסים
[[:נחל צולב]]	נחל צולב
[[:פאדי אל-עלמי]]	פאדי אל-עלמי
[[:בצלאל בזק]]	בצלאל בזק
[[:תוכנית מקלין]]	תוכנית מקלין
[[:תוכנית גדס-אשבי]]	תוכנית גדס-אשבי
[[:ההתקפה על המרכז המסחרי בממילא]]	ההתקפה על המרכז המסחרי בממילא
[[:טבע עירוני בירושלים]]	טבע עירוני בירושלים
[[:קולנוע אוריון]]	קולנוע אוריון
