ישראל - פוליטיקה
[[:ליאורה גלט-ברקוביץ']]	ליאורה גלט-ברקוביץ'
[[:חברת העובדים]]	חברת העובדים
[[:ארגוני שמאל בישראל]]	ארגוני שמאל בישראל
[[:פורום משפטי למען ארץ ישראל]]	פורום משפטי למען ארץ ישראל
[[:תקנות שעת חירום]]	תקנות שעת חירום
[[:עקורי איקרית ובירעם]]	עקורי איקרית ובירעם
[[:משכן הכנסת]]	משכן הכנסת
[[:חיים הברפלד]]	חיים הברפלד
[[:ביצוע תוכנית ההתנתקות]]	ביצוע תוכנית ההתנתקות
[[:השמינייה (מפלגת העבודה)]]	השמינייה (מפלגת העבודה)
[[:חד"ש-בל"ד]]	חד"ש-בל"ד
[[:הליכוד-גשר-צומת]]	הליכוד-גשר-צומת
[[:חד"ש-תע"ל]]	חד"ש-תע"ל
[[:מד"ע-רע"ם]]	מד"ע-רע"ם
[[:תוכנית הקנטונים]]	תוכנית הקנטונים
[[:עבודה-מימד]]	עבודה-מימד
[[:הציונות החדשה]]	הציונות החדשה
[[:סיקור מות סטלין ב"על המשמר"]]	סיקור מות סטלין ב"על המשמר"
[[:ליל המיקרופונים]]	ליל המיקרופונים
[[:הכנסת השבע עשרה]]	הכנסת השבע עשרה
[[:הכנסת השש עשרה]]	הכנסת השש עשרה
[[:הכנסת החמש עשרה]]	הכנסת החמש עשרה
[[:אבי בלשניקוב]]	אבי בלשניקוב
[[:העיניים של המדינה]]	העיניים של המדינה
&rlm;[[:ליל הברווזים (1979)]]&rlm;	ליל הברווזים (1979)
[[:נדב פרי]]	נדב פרי
[[:דרך הניצוץ]]	דרך הניצוץ
[[:אשר ידלין]]	אשר ידלין
[[:אגודת הסטודנטים של אוניברסיטת תל אביב]]	אגודת הסטודנטים של אוניברסיטת תל אביב
[[:טל זילברשטיין]]	טל זילברשטיין
[[:יעקב סנדלר]]	יעקב סנדלר
[[:מקאומה]]	מקאומה
[[:מרצ-הבחירה הדמוקרטית-שח"ר]]	מרצ-הבחירה הדמוקרטית-שח"ר
[[:ויקי קנפו]]	ויקי קנפו
[[:זורח שבץ]]	זורח שבץ
[[:פנחס אילון]]	פנחס אילון
[[:עמנואל ולד]]	עמנואל ולד
[[:ועדה מסדרת]]	ועדה מסדרת
[[:קטגוריה:מנחם בגין]]	מנחם בגין
[[:קטגוריה:דוד בן-גוריון]]	דוד בן-גוריון
[[:קטגוריה:שמעון פרס]]	שמעון פרס
[[:דו"ח ליטבק]]	דו"ח ליטבק
[[:עיר לכולנו]]	עיר לכולנו
[[:יוסי קוצ'יק]]	יוסי קוצ'יק
[[:מזנון הכנסת]]	מזנון הכנסת
[[:שמאל רדיקלי בישראל]]	שמאל רדיקלי בישראל
