ישראל - תרבות
[[:צוותא]]	צוותא
[[:אברהם דשא (פשנל)]]	אברהם דשא (פשנל)
&rlm;[[:פנטסיה 2000 (כתב עת)]]&rlm;	פנטסיה 2000 (כתב עת)
[[:בומבה צור]]	בומבה צור
[[:משפחת בנאי]]	משפחת בנאי
[[:אברהם חלפי]]	אברהם חלפי
[[:חבורת לול]]	חבורת לול
[[:יעל דואני]]	יעל דואני
[[:תרבות ישראלית אלטרנטיבית]]	תרבות ישראלית אלטרנטיבית
[[:יום הזיכרון ליצחק רבין]]	יום הזיכרון ליצחק רבין
[[:סיגריות מספרו]]	סיגריות מספרו
[[:גיא פינס]]	גיא פינס
[[:ישראל נגריס]]	ישראל נגריס
[[:פרס מוזיאון ישראל לאיור ספר ילדים על שם בן-יצחק]]	פרס מוזיאון ישראל לאיור ספר ילדים על שם בן-יצחק
[[:מדיטק]]	מדיטק
[[:איגודי הבמאים והתסריטאים בישראל]]	איגודי הבמאים והתסריטאים בישראל
[[:קטגוריה:משפחת גפן]]	משפחת גפן
[[:אבשלום עוקשי]]	אבשלום עוקשי
[[:מיכאל אוהד]]	מיכאל אוהד
[[:יוסף אהרונוביץ']]	יוסף אהרונוביץ'
[[:משה ולין]]	משה ולין
[[:טובה חסין]]	טובה חסין
[[:הלוגוס]]	הלוגוס
[[:לגעת ברוח]]	לגעת ברוח
[[:רפיק ידידיה]]	רפיק ידידיה
&rlm;[[:איל B]]&rlm;	איל B
[[:קולנוע שרון]]	קולנוע שרון
[[:מוטי ברכאן]]	מוטי ברכאן
[[:קטגוריה:תל אביב-יפו: תרבות]]	תל אביב-יפו: תרבות
[[:ד. אליר]]	ד. אליר
[[:ציפר]]	ציפר
[[:אורן מיילי]]	אורן מיילי
[[:ורטיגו (להקה)]]	ורטיגו (להקה)
[[:מושונוב]]	מושונוב
[[:קטגוריה:יהודה ושומרון: מוזיאונים]]	יהודה ושומרון: מוזיאונים
