ישראל - טלוויזיה
[[:פרנקו וספקטור]]	פרנקו וספקטור
[[:שמש (סדרת טלוויזיה)]]	שמש (סדרת טלוויזיה)
[[:שלוש ארבע חמש וחצי]]	שלוש ארבע חמש וחצי
[[:ריצ'רץ' (תוכנית טלוויזיה)]]	ריצ'רץ' (תוכנית טלוויזיה)
[[:המחסן של כאילו]]	המחסן של כאילו
[[:על מלי ולמה]]	על מלי ולמה
[[:עץ הפיטפוזים]]	עץ הפיטפוזים
[[:גינת ההפתעות]]	גינת ההפתעות
[[:מיכאלה]]	מיכאלה
[[:סיפורים לשעת לילה מאוחרת]]	סיפורים לשעת לילה מאוחרת
[[:שוטטות (סדרת טלוויזיה)]]	שוטטות (סדרת טלוויזיה)
[[:בשידור חוקר]]	בשידור חוקר
[[:יצחק שמעוני]]	יצחק שמעוני
[[:כל לילה עם אסף הראל]]	כל לילה עם אסף הראל
[[:אסף הראל]]	אסף הראל
[[:סמי וסוסו]]	סמי וסוסו
[[:הופה היי]]	הופה היי
[[:יורם רונן]]	יורם רונן
[[:אסתר סופר]]	אסתר סופר
[[:אלי ישראלי]]	אלי ישראלי
[[:אהבה מעבר לפינה]]	אהבה מעבר לפינה
[[:השגריר]]	השגריר
[[:ספי ריבלין]]	ספי ריבלין
[[:אבישי ההורס]]	אבישי ההורס
[[:דרוש מנהיג]]	דרוש מנהיג
[[:בטריבונה]]	בטריבונה
[[:אקזיט (תוכנית טלוויזיה)]]	אקזיט (תוכנית טלוויזיה)
[[:כמעט חצות]]	כמעט חצות
[[:יצחק רועה]]	יצחק רועה
[[:הרצועה]]	הרצועה
[[:ניקוי ראש]]	ניקוי ראש
[[:נתן זהבי]]	נתן זהבי
[[:נפתלי מנשה]]	נפתלי מנשה
[[:ספי בן יוסף]]	ספי בן יוסף
[[:גיל ססובר]]	גיל ססובר
[[:לול (תוכנית טלוויזיה)]]	לול (תוכנית טלוויזיה)
[[:מבט ספורט]]	מבט ספורט
&rlm;[[:זה הזמן (תוכנית טלוויזיה, ערוץ 10)]]&rlm;	זה הזמן (תוכנית טלוויזיה, ערוץ 10)
[[:אחורי החדשות]]	אחורי החדשות
[[:לימוזינה (תוכנית טלוויזיה)]]	לימוזינה (תוכנית טלוויזיה)
[[:רפי רשף]]	רפי רשף
[[:מלי לוי]]	מלי לוי
[[:יעל דואני]]	יעל דואני
[[:טלי מורנו]]	טלי מורנו
[[:מודי בר-און]]	מודי בר-און
[[:יוסי טרבלוס]]	יוסי טרבלוס
[[:לילך סונין]]	לילך סונין
[[:מכת מדינה]]	מכת מדינה
[[:יקיר אביב]]	יקיר אביב
[[:מאיר איינשטיין]]	מאיר איינשטיין
[[:מעורב ירושלמי (סדרת טלוויזיה)]]	מעורב ירושלמי (סדרת טלוויזיה)
[[:חלום עליכם]]	חלום עליכם
[[:יצחק לבני]]	יצחק לבני
[[:לתפוס את השמים]]	לתפוס את השמים
[[:חדר מלחמה (סדרת טלוויזיה)]]	חדר מלחמה (סדרת טלוויזיה)
[[:טלנובלה בע"מ]]	טלנובלה בע"מ
[[:דב נבון]]	דב נבון
[[:קריאת כיוון]]	קריאת כיוון
[[:העולם הערב]]	העולם הערב
[[:עינב גלילי]]	עינב גלילי
[[:אריה מליניאק]]	אריה מליניאק
[[:חצי המנשה]]	חצי המנשה
[[:דני שגב]]	דני שגב
[[:זומביט]]	זומביט
[[:שערורייה (תוכנית טלוויזיה)]]	שערורייה (תוכנית טלוויזיה)
[[:עולמו של רנו פסקאל]]	עולמו של רנו פסקאל
[[:אדם ומלואו]]	אדם ומלואו
[[:מסיבת גן]]	מסיבת גן
[[:הצלצול הוא בשבילי]]	הצלצול הוא בשבילי
[[:בנות בראון]]	בנות בראון
[[:מפגשיר]]	מפגשיר
&rlm;[[:9 שעות ושיר]]&rlm;	9 שעות ושיר
[[:בחדר של חני]]	בחדר של חני
[[:משה טימור]]	משה טימור
[[:ראש גדול]]	ראש גדול
[[:אמא'לה]]	אמא'לה
[[:גיא פינס]]	גיא פינס
[[:יעל גולדמן]]	יעל גולדמן
[[:ליאור שליין]]	ליאור שליין
[[:לינוי בר-גפן]]	לינוי בר-גפן
[[:טטיאנה הופמן]]	טטיאנה הופמן
[[:העולם הבוקר]]	העולם הבוקר
[[:תמר מרום]]	תמר מרום
[[:אהבה זה כואב]]	אהבה זה כואב
[[:ככה לא מתנהגים]]	ככה לא מתנהגים
[[:מה זה השטויות האלה?!]]	מה זה השטויות האלה?!
[[:היכל התרבות (תוכנית טלוויזיה)]]	היכל התרבות (תוכנית טלוויזיה)
[[:קטגוריה:רשת (זכיינית שידור)]]	רשת (זכיינית שידור)
[[:נולד לרקוד]]	נולד לרקוד
[[:עובדה (תוכנית טלוויזיה)]]	עובדה (תוכנית טלוויזיה)
[[:שבתות וחגים (סדרת טלוויזיה)]]	שבתות וחגים (סדרת טלוויזיה)
[[:שומר מסך (תוכנית טלוויזיה)]]	שומר מסך (תוכנית טלוויזיה)
[[:פיק אפ (סדרת טלוויזיה)]]	פיק אפ (סדרת טלוויזיה)
[[:גיל פרנק]]	גיל פרנק
[[:אסף צפור]]	אסף צפור
[[:זינזאנה]]	זינזאנה
&rlm;[[:Here we are]]&rlm;	Here we are
[[:עמוס כרמלי]]	עמוס כרמלי
&rlm;[[:Neighbours]]&rlm;	Neighbours
[[:פיצוחים (שעשועון)]]	פיצוחים (שעשועון)
[[:גיל ריבה]]	גיל ריבה
[[:רפי גינת]]	רפי גינת
[[:ערב טוב עם גיא פינס]]	ערב טוב עם גיא פינס
[[:יאיר לפיד (תוכנית טלוויזיה)]]	יאיר לפיד (תוכנית טלוויזיה)
[[:אחי! אחותי!]]	אחי! אחותי!
[[:פרשת השבוע (סדרת טלוויזיה)]]	פרשת השבוע (סדרת טלוויזיה)
[[:אורי חזקיה]]	אורי חזקיה
[[:אבי טרמין]]	אבי טרמין
[[:פספוסים]]	פספוסים
[[:גלעד עדין]]	גלעד עדין
[[:רינו צרור]]	רינו צרור
[[:גיא זהר]]	גיא זהר
&rlm;[[:אחד העם 1]]&rlm;	אחד העם 1
[[:רכבת ההפתעות]]	רכבת ההפתעות
[[:שלמה ניצן (שחקן)]]	שלמה ניצן (שחקן)
[[:חוצה ישראל (תוכנית טלוויזיה)]]	חוצה ישראל (תוכנית טלוויזיה)
[[:בועז עופרי]]	בועז עופרי
[[:רמת אביב גימל]]	רמת אביב גימל
[[:קשת וענן]]	קשת וענן
[[:ילדות רעות]]	ילדות רעות
[[:בנות (תוכנית טלוויזיה)]]	בנות (תוכנית טלוויזיה)
[[:האלופה]]	האלופה
[[:בבית של פיסטוק]]	בבית של פיסטוק
[[:שי ודרור]]	שי ודרור
[[:איפה אתה חי?!]]	איפה אתה חי?!
[[:אלכס אנסקי]]	אלכס אנסקי
[[:טלי שמש]]	טלי שמש
[[:מיכל גבריאלוב]]	מיכל גבריאלוב
[[:בלאגן (תוכנית טלוויזיה)]]	בלאגן (תוכנית טלוויזיה)
[[:ניראל קאראנתינג'י]]	ניראל קאראנתינג'י
[[:אבי מלר]]	אבי מלר
[[:יורם ארבל]]	יורם ארבל
[[:חלומות בהקיציס]]	חלומות בהקיציס
[[:הצצקנים]]	הצצקנים
[[:סיגלית פוקס]]	סיגלית פוקס
[[:משפחת קמיצ'לי]]	משפחת קמיצ'לי
[[:איתי תורג'מן]]	איתי תורג'מן
[[:דני קושמרו]]	דני קושמרו
[[:פסטיבל השירים של ישראל]]	פסטיבל השירים של ישראל
[[:דלת הקסמים]]	דלת הקסמים
[[:עושים צחוק]]	עושים צחוק
[[:תמונות יפואיות]]	תמונות יפואיות
[[:זהב לבן עבודה שחורה]]	זהב לבן עבודה שחורה
[[:גל זייד]]	גל זייד
[[:תיק תקשורת]]	תיק תקשורת
[[:שידורי המהפכה]]	שידורי המהפכה
[[:דרור קרן]]	דרור קרן
[[:קרוב לוודאי (סדרת טלוויזיה)]]	קרוב לוודאי (סדרת טלוויזיה)
[[:טדי יזמות והפקות]]	טדי יזמות והפקות
[[:בסימן ונוס (מיני סדרה)]]	בסימן ונוס (מיני סדרה)
[[:משחק החיים (טלנובלה)]]	משחק החיים (טלנובלה)
[[:הבוקר השביעי]]	הבוקר השביעי
[[:ענת מגן-שבו]]	ענת מגן-שבו
[[:דומינו (תוכנית טלוויזיה)]]	דומינו (תוכנית טלוויזיה)
[[:הפוך]]	הפוך
[[:פלורנטין (סדרת טלוויזיה)]]	פלורנטין (סדרת טלוויזיה)
[[:שי זורניצר]]	שי זורניצר
[[:מילואים (סדרת טלוויזיה)]]	מילואים (סדרת טלוויזיה)
[[:סיון רהב-מאיר]]	סיון רהב-מאיר
[[:ארז פריש]]	ארז פריש
[[:חתה יסבח סבח]]	חתה יסבח סבח
&rlm;[[:ערוץ 8]]&rlm;	ערוץ 8
[[:בחזרה לתחתית]]	בחזרה לתחתית
[[:כל בוקר]]	כל בוקר
[[:ערוץ אנימה]]	ערוץ אנימה
[[:דנה ספקטור]]	דנה ספקטור
[[:שניים (תוכנית טלוויזיה)]]	שניים (תוכנית טלוויזיה)
[[:טירונות (סדרת טלוויזיה)]]	טירונות (סדרת טלוויזיה)
[[:לחיי האהבה]]	לחיי האהבה
[[:לגעת באושר]]	לגעת באושר
[[:הילדים מגבעת נפוליאון]]	הילדים מגבעת נפוליאון
[[:הדוברמן החברמן]]	הדוברמן החברמן
[[:צלילים מן ההיכל]]	צלילים מן ההיכל
[[:קחי אותי שרון]]	קחי אותי שרון
[[:שישי עם מיכל]]	שישי עם מיכל
[[:פלטפוס (תוכנית טלוויזיה)]]	פלטפוס (תוכנית טלוויזיה)
[[:יעל הדר]]	יעל הדר
[[:יעל הדר]]	יעל הדר
[[:צדי צרפתי]]	צדי צרפתי
[[:דליק ווליניץ]]	דליק ווליניץ
[[:יומן חייתי]]	יומן חייתי
[[:נדב פרי]]	נדב פרי
[[:יצאת צדיק]]	יצאת צדיק
[[:אילן רועה]]	אילן רועה
[[:עמוס אטינגר]]	עמוס אטינגר
[[:חיים שכאלה]]	חיים שכאלה
[[:אדומות]]	אדומות
[[:יעל שרוני]]	יעל שרוני
[[:אלי אילדיס]]	אלי אילדיס
[[:שתיקת הצופרים]]	שתיקת הצופרים
[[:סוף הדרך (תוכנית טלוויזיה)]]	סוף הדרך (תוכנית טלוויזיה)
[[:רייטינג (שבועון)]]	רייטינג (שבועון)
[[:סלימאן א-שאפעי]]	סלימאן א-שאפעי
[[:דורי בן זאב]]	דורי בן זאב
[[:ורד פלדמן]]	ורד פלדמן
[[:אביעד קיסוס]]	אביעד קיסוס
[[:עמנואל דודאי]]	עמנואל דודאי
[[:ששטוס]]	ששטוס
[[:דן כנר]]	דן כנר
[[:אינטרמצו עם אריק]]	אינטרמצו עם אריק
[[:החטא ועונשו (תוכנית טלוויזיה)]]	החטא ועונשו (תוכנית טלוויזיה)
[[:אולפן שישי]]	אולפן שישי
[[:מת להיות]]	מת להיות
[[:הבוקר של קשת]]	הבוקר של קשת
[[:האקדמיה לצחוק]]	האקדמיה לצחוק
[[:ערן זרחוביץ']]	ערן זרחוביץ'
[[:נמרוד רשף]]	נמרוד רשף
[[:הילדים משכונת חיים]]	הילדים משכונת חיים
[[:בת ים - ניו יורק]]	בת ים - ניו יורק
[[:זה הסוד שלי]]	זה הסוד שלי
[[:לא כולל שירות]]	לא כולל שירות
[[:שיחה צפופה]]	שיחה צפופה
[[:מנחם הורוביץ]]	מנחם הורוביץ
[[:גל נדיבי]]	גל נדיבי
[[:פפראצי (תוכנית טלוויזיה)]]	פפראצי (תוכנית טלוויזיה)
[[:דרור רפאל]]	דרור רפאל
[[:גומרות הולכות]]	גומרות הולכות
[[:לא הבטחתי לך]]	לא הבטחתי לך
[[:צחי גראד]]	צחי גראד
[[:המונה דופק]]	המונה דופק
[[:שוטרים]]	שוטרים
[[:דידי הררי]]	דידי הררי
[[:תיק סגור]]	תיק סגור
[[:נייס גיא]]	נייס גיא
[[:הלילה עם ליאור שליין]]	הלילה עם ליאור שליין
[[:יעל דן]]	יעל דן
[[:מיכל גרונדלנד]]	מיכל גרונדלנד
[[:בשורות טובות (סדרת טלוויזיה)]]	בשורות טובות (סדרת טלוויזיה)
[[:המשמר האזרחי (תוכנית טלוויזיה)]]	המשמר האזרחי (תוכנית טלוויזיה)
[[:שחק אותה]]	שחק אותה
[[:דב גליקמן]]	דב גליקמן
[[:שי קפון]]	שי קפון
[[:פעם בחיים (סדרת טלוויזיה)]]	פעם בחיים (סדרת טלוויזיה)
[[:דוקוסלב]]	דוקוסלב
[[:טוביה דובלרו]]	טוביה דובלרו
[[:אולי הפעם]]	אולי הפעם
[[:יואב גינאי]]	יואב גינאי
[[:איצ'ה]]	איצ'ה
[[:חגי פינסקר]]	חגי פינסקר
[[:אריה אורגד]]	אריה אורגד
[[:צדוק סביר]]	צדוק סביר
[[:הישראלים (תוכנית טלוויזיה)]]	הישראלים (תוכנית טלוויזיה)
[[:טלפלא]]	טלפלא
[[:אישי עם גיל ריבה]]	אישי עם גיל ריבה
[[:טל גלעד]]	טל גלעד
&rlm;[[:רואים 6/6]]&rlm;	רואים 6/6
[[:ארז בן הרוש]]	ארז בן הרוש
[[:שי גולדשטיין]]	שי גולדשטיין
[[:עשר הכי]]	עשר הכי
[[:מרגיש בבית]]	מרגיש בבית
[[:קרוסלה (תוכנית טלוויזיה)]]	קרוסלה (תוכנית טלוויזיה)
[[:טובה חסין]]	טובה חסין
[[:רוני דניאל]]	רוני דניאל
[[:גיא מרוז]]	גיא מרוז
[[:אורלי וילנאי]]	אורלי וילנאי
[[:משה גביש]]	משה גביש
[[:הצופן (סדרת טלוויזיה)]]	הצופן (סדרת טלוויזיה)
[[:תופסים ראש]]	תופסים ראש
[[:חדווה ושלומיק]]	חדווה ושלומיק
[[:הבורר]]	הבורר
[[:תלויים באוויר]]	תלויים באוויר
[[:החופש האחרון]]	החופש האחרון
[[:המובילים]]	המובילים
[[:ז'יל בן דוד]]	ז'יל בן דוד
[[:אגדת דשא (סדרת טלוויזיה)]]	אגדת דשא (סדרת טלוויזיה)
[[:חנן לדרמן]]	חנן לדרמן
[[:דני קרפל (קומיקאי)]]	דני קרפל (קומיקאי)
&rlm;[[:20 פלוס]]&rlm;	20 פלוס
[[:כסף קטלני (סדרת טלוויזיה)]]	כסף קטלני (סדרת טלוויזיה)
[[:האקס המיתולוגי]]	האקס המיתולוגי
&rlm;[[:2003 בטלוויזיה בישראל]]&rlm;	2003 בטלוויזיה בישראל
[[:ריח מנטה]]	ריח מנטה
[[:מוצ"ש (תוכנית טלוויזיה)]]	מוצ"ש (תוכנית טלוויזיה)
[[:נדב אבקסיס]]	נדב אבקסיס
[[:תוססס]]	תוססס
[[:יעל קרוון]]	יעל קרוון
[[:מהדורה מוגבלת (תוכנית טלוויזיה)]]	מהדורה מוגבלת (תוכנית טלוויזיה)
[[:נחמיה שטרסלר]]	נחמיה שטרסלר
[[:הכל דבש]]	הכל דבש
[[:שיישאר בינינו]]	שיישאר בינינו
[[:צביקה קרצנר]]	צביקה קרצנר
[[:לגעת ברוח]]	לגעת ברוח
[[:סיבה למסיבה]]	סיבה למסיבה
[[:כן מה?!]]	כן מה?!
[[:תקומה (סדרת טלוויזיה)]]	תקומה (סדרת טלוויזיה)
[[:עלי כותרת (תוכנית טלוויזיה)]]	עלי כותרת (תוכנית טלוויזיה)
[[:עוד להיט]]	עוד להיט
[[:להיט בראש]]	להיט בראש
[[:שולחן ארוך עם דורון נשר]]	שולחן ארוך עם דורון נשר
[[:קרב סכינים]]	קרב סכינים
[[:ציפי גון-גרוס]]	ציפי גון-גרוס
[[:חמש וחצי]]	חמש וחצי
[[:חן קלימן]]	חן קלימן
[[:החצר]]	החצר
[[:גבי ודבי]]	גבי ודבי
[[:בסוד העניינים]]	בסוד העניינים
&rlm;[[:Candy Can Do It]]&rlm;	Candy Can Do It
[[:האי (סדרת טלוויזיה)]]	האי (סדרת טלוויזיה)
[[:משמורת (סדרת טלוויזיה)]]	משמורת (סדרת טלוויזיה)
&rlm;[[:Seven in Heaven]]&rlm;	Seven in Heaven
[[:בובות (טלנובלה)]]	בובות (טלנובלה)
[[:גאולה אבן]]	גאולה אבן
[[:אדם שוב]]	אדם שוב
[[:יוסי סיאס]]	יוסי סיאס
[[:שכנים (סדרת טלוויזיה)]]	שכנים (סדרת טלוויזיה)
[[:סטרייט ולעניין]]	סטרייט ולעניין
[[:פאזל (סדרת טלוויזיה)]]	פאזל (סדרת טלוויזיה)
[[:כרמית גיא]]	כרמית גיא
[[:ייסורי אפרים]]	ייסורי אפרים
[[:לילה גוב]]	לילה גוב
[[:רפיק ידידיה]]	רפיק ידידיה
[[:דורון נשר]]	דורון נשר
[[:שישי בגאון]]	שישי בגאון
[[:ציפי בלי הפסקה]]	ציפי בלי הפסקה
[[:יום יומן]]	יום יומן
[[:כנגד כל הסיכויים]]	כנגד כל הסיכויים
[[:ג'וני]]	ג'וני
[[:שמוליק טיאר]]	שמוליק טיאר
[[:הסודות של כנרת]]	הסודות של כנרת
[[:שאול (סדרת טלוויזיה)]]	שאול (סדרת טלוויזיה)
[[:אילן פלד]]	אילן פלד
[[:סוף עונת התפוזים - סיפורו של הרוק הישראלי]]	סוף עונת התפוזים - סיפורו של הרוק הישראלי
[[:צבי שיסל]]	צבי שיסל
[[:עד פופ]]	עד פופ
[[:להוציא את הכלב]]	להוציא את הכלב
[[:פרפר לילה (תוכנית טלוויזיה)]]	פרפר לילה (תוכנית טלוויזיה)
[[:תעשה לי ילד (סדרת טלוויזיה)]]	תעשה לי ילד (סדרת טלוויזיה)
[[:יעל לבנטל]]	יעל לבנטל
[[:חשופים]]	חשופים
[[:אבישי אביבי]]	אבישי אביבי
[[:דפנה לוסטיג]]	דפנה לוסטיג
[[:גדי ליבנה]]	גדי ליבנה
[[:באה בטוב]]	באה בטוב
[[:משפחה וחצי]]	משפחה וחצי
[[:גיורא קנת]]	גיורא קנת
&rlm;[[:Sing a song]]&rlm;	Sing a song
[[:אבידות ומציאות]]	אבידות ומציאות
[[:מושיק גלאמין]]	מושיק גלאמין
[[:פאפאדיזי]]	פאפאדיזי
[[:צחוק מעבודה]]	צחוק מעבודה
[[:ניר רון]]	ניר רון
[[:אילנית גרשון]]	אילנית גרשון
[[:ימית סול]]	ימית סול
[[:כתב פלילי (סדרת טלוויזיה)]]	כתב פלילי (סדרת טלוויזיה)
[[:אבי נוסבאום]]	אבי נוסבאום
[[:רזי ברקאי]]	רזי ברקאי
[[:תיכון השיר שלנו]]	תיכון השיר שלנו
[[:דני דויטש]]	דני דויטש
[[:מנדלבאום בלש פרטי]]	מנדלבאום בלש פרטי
[[:סיגל שחמון]]	סיגל שחמון
[[:שירות חדרים (סדרת טלוויזיה)]]	שירות חדרים (סדרת טלוויזיה)
[[:קטגוריה:שנים בטלוויזיה בישראל]]	שנים בטלוויזיה בישראל
[[:רענן דינור]]	רענן דינור
[[:אביב אלוש]]	אביב אלוש
[[:עוזי פלד]]	עוזי פלד
[[:מה אתם הייתם עושים?]]	מה אתם הייתם עושים?
[[:נשות הטייסים]]	נשות הטייסים
[[:ארבעה בעקבות החג]]	ארבעה בעקבות החג
[[:אות אות אות]]	אות אות אות
