ישראל - אקדמיה
[[:מנחם פרי]]	מנחם פרי
[[:שמחה אסף]]	שמחה אסף
[[:ארנון גוטפלד]]	ארנון גוטפלד
[[:חיים בלנק]]	חיים בלנק
[[:אשר סילפן]]	אשר סילפן
[[:משה רינות]]	משה רינות
[[:רות בן-ישראל]]	רות בן-ישראל
[[:אשר עידן]]	אשר עידן
[[:ישראל שצמן]]	ישראל שצמן
[[:עזרא מני]]	עזרא מני
[[:ישראל מ' תא-שמע]]	ישראל מ' תא-שמע
[[:גד בן-עמי צרפתי]]	גד בן-עמי צרפתי
[[:פאול זינגר]]	פאול זינגר
[[:אבי שגיא]]	אבי שגיא
[[:שמואל שור]]	שמואל שור
[[:זיוה שמיר]]	זיוה שמיר
[[:אוניברסיטה משודרת]]	אוניברסיטה משודרת
[[:יהושע מאיר גרינץ]]	יהושע מאיר גרינץ
[[:בנימין איש-שלום]]	בנימין איש-שלום
[[:חיים ברקאי]]	חיים ברקאי
[[:גדעון הנמן]]	גדעון הנמן
[[:דב ירדן]]	דב ירדן
[[:דרור פיקסלר]]	דרור פיקסלר
[[:רענן ויץ]]	רענן ויץ
[[:קלר אפשטין]]	קלר אפשטין
[[:ורדה אלשיך]]	ורדה אלשיך
[[:יהושע בן אריה]]	יהושע בן אריה
[[:ישראל קלוזנר]]	ישראל קלוזנר
[[:מישל רבל]]	מישל רבל
[[:הקליניקות המשפטיות באוניברסיטת תל אביב]]	הקליניקות המשפטיות באוניברסיטת תל אביב
[[:משה ברש]]	משה ברש
[[:משה רון]]	משה רון
[[:עודד בלבן]]	עודד בלבן
[[:רון שפירא]]	רון שפירא
[[:אהרן שי]]	אהרן שי
[[:יוסף דרורי]]	יוסף דרורי
[[:אסמעיל אבו סעד]]	אסמעיל אבו סעד
[[:יהודה רצהבי]]	יהודה רצהבי
[[:משה ברור]]	משה ברור
[[:שמעון נוה]]	שמעון נוה
[[:עמנואל ולד]]	עמנואל ולד
[[:משה שוקד]]	משה שוקד
[[:אוריה שביט]]	אוריה שביט
&rlm;[[:Estudios Interdisciplinarios América Latina y el Caribe]]&rlm;	Estudios Interdisciplinarios América Latina y el Caribe
[[:שמעון רדליך]]	שמעון רדליך
[[:דן מכמן]]	דן מכמן
[[:צבי זלינגר]]	צבי זלינגר
[[:אביגדור שנאן]]	אביגדור שנאן
[[:גבריאל בר]]	גבריאל בר
[[:משה אורן]]	משה אורן
[[:ירמי פינקוס]]	ירמי פינקוס
[[:אבי בן-בסט]]	אבי בן-בסט
[[:רינה דרורי]]	רינה דרורי
[[:אבנר גלעדי]]	אבנר גלעדי
[[:חדוה בן-ישראל]]	חדוה בן-ישראל
[[:דרור אידר]]	דרור אידר
[[:ישראל אור-בך]]	ישראל אור-בך
[[:שולמית אלמוג]]	שולמית אלמוג
[[:עדי צמח]]	עדי צמח
[[:דוד סולברג]]	דוד סולברג
[[:ג'ראלד קרומר]]	ג'ראלד קרומר
[[:גדעון פרסטר]]	גדעון פרסטר
[[:יופי תירוש]]	יופי תירוש
[[:אדיר פרידור]]	אדיר פרידור
