ישראל - כלכלה
[[:עמירם סיון]]	עמירם סיון
[[:מרכז מסחרי]]	מרכז מסחרי
[[:ישראל רוגוזין]]	ישראל רוגוזין
[[:יחזקאל זונאבנד]]	יחזקאל זונאבנד
[[:יעקב גדיש]]	יעקב גדיש
[[:חברת העובדים]]	חברת העובדים
[[:בנק קופת עם]]	בנק קופת עם
[[:החברה הישראלית למדליות ולמטבעות]]	החברה הישראלית למדליות ולמטבעות
[[:אברהם אלתר]]	אברהם אלתר
[[:משה מנדלבאום]]	משה מנדלבאום
[[:הלל דן]]	הלל דן
[[:רפי פלד]]	רפי פלד
[[:מאיר כוכב זסלבסקי]]	מאיר כוכב זסלבסקי
[[:שמואל בן-טובים]]	שמואל בן-טובים
[[:קרן השתלמות]]	קרן השתלמות
[[:חיים ברקאי]]	חיים ברקאי
[[:תוכנית מהל"ב]]	תוכנית מהל"ב
&rlm;[[:ליל הברווזים (1979)]]&rlm;	ליל הברווזים (1979)
[[:ש. פרידמן בע"מ]]	ש. פרידמן בע"מ
[[:הרפורמה בענף החלב]]	הרפורמה בענף החלב
[[:מיכאיל ברודנו]]	מיכאיל ברודנו
[[:תוכנית ספדיה]]	תוכנית ספדיה
[[:עובד בן עמי]]	עובד בן עמי
[[:משה ליכטמן]]	משה ליכטמן
[[:ויסות שערי ניירות הערך קודם למשבר מניות הבנקים בישראל]]	ויסות שערי ניירות הערך קודם למשבר מניות הבנקים בישראל
[[:ויקי קנפו]]	ויקי קנפו
[[:ג'מילה חיר]]	ג'מילה חיר
[[:דב פטישי]]	דב פטישי
[[:שלמה נחמה]]	שלמה נחמה
[[:משה גביש]]	משה גביש
[[:משה ליפל]]	משה ליפל
[[:נחמיה שטרסלר]]	נחמיה שטרסלר
[[:שמחה גולן]]	שמחה גולן
[[:משה ליטוינסקי]]	משה ליטוינסקי
[[:טלמאפ]]	טלמאפ
&rlm;[[:Yellow (רשת חנויות)]]&rlm;	Yellow (רשת חנויות)
[[:זהבית כהן]]	זהבית כהן
[[:ליאון רקנאטי (הנכד)]]	ליאון רקנאטי (הנכד)
[[:ישראל מקוב]]	ישראל מקוב
[[:מאיר גורביץ]]	מאיר גורביץ
[[:ישראל ליברטובסקי]]	ישראל ליברטובסקי
[[:חרש אופן]]	חרש אופן
[[:רענן דינור]]	רענן דינור
[[:משה דנקנר]]	משה דנקנר
[[:שמואל דנקנר]]	שמואל דנקנר
[[:מפעלי חבל מעון]]	מפעלי חבל מעון
