ישראל - ממשל
[[:תסקיר השפעה על הסביבה]]	תסקיר השפעה על הסביבה
[[:כנסת ישראל]]	כנסת ישראל
[[:ועדת חקירה ממלכתית]]	ועדת חקירה ממלכתית
[[:משכן הכנסת]]	משכן הכנסת
[[:תהיל"ה]]	תהיל"ה
[[:נכות בישראל]]	נכות בישראל
[[:סל הבריאות]]	סל הבריאות
[[:פקודת מס הכנסה]]	פקודת מס הכנסה
[[:פקודת העיריות]]	פקודת העיריות
[[:קטגוריה:ישראל: ועדות חקירה]]	ישראל: ועדות חקירה
[[:תוכנית מתאר מקומית]]	תוכנית מתאר מקומית
[[:תוכנית מפורטת]]	תוכנית מפורטת
[[:תוכנית מתאר מחוזית]]	תוכנית מתאר מחוזית
[[:תוכנית מתאר ארצית]]	תוכנית מתאר ארצית
[[:קטגוריה:ישראל: תכנון ובנייה]]	ישראל: תכנון ובנייה
[[:יואל אלראי]]	יואל אלראי
[[:תוכנית דרך]]	תוכנית דרך
[[:תוכנית הגשה]]	תוכנית הגשה
[[:תוכנית מהל"ב]]	תוכנית מהל"ב
[[:חוק יסוד: משק המדינה]]	חוק יסוד: משק המדינה
[[:קטגוריה:ישראל: ועדות בדיקה ממשלתיות]]	ישראל: ועדות בדיקה ממשלתיות
[[:כיכר הלחם]]	כיכר הלחם
[[:קורס צוערים]]	קורס צוערים
[[:משה קרונה]]	משה קרונה
[[:ועדת זורע]]	ועדת זורע
[[:משה גביש]]	משה גביש
[[:משה ברור]]	משה ברור
[[:אבי ביצור]]	אבי ביצור
[[:אבי זכאי]]	אבי זכאי
[[:ועדה קרואה]]	ועדה קרואה
[[:עיטור לוחמי המדינה]]	עיטור לוחמי המדינה
[[:ועדת שרים]]	ועדת שרים
[[:יעל פוזנר]]	יעל פוזנר
[[:משרד ההסברה]]	משרד ההסברה
[[:נציבות שוויון זכויות לאנשים עם מוגבלות]]	נציבות שוויון זכויות לאנשים עם מוגבלות
[[:היטל הטמנה]]	היטל הטמנה
[[:נציבות קבילות הציבור לחוק ביטוח בריאות ממלכתי]]	נציבות קבילות הציבור לחוק ביטוח בריאות ממלכתי
[[:עיריית פתח תקווה]]	עיריית פתח תקווה
[[:רענן דינור]]	רענן דינור
[[:מנהל אכיפה וזרים]]	מנהל אכיפה וזרים
