ישראל - היסטוריה
[[:בית הסופר]]	בית הסופר
[[:פאריטה]]	פאריטה
[[:הבריחות ממחנות המעצר באפריקה]]	הבריחות ממחנות המעצר באפריקה
[[:תגובת החברה הדתית לרצח רבין]]	תגובת החברה הדתית לרצח רבין
[[:טוביה קושניר]]	טוביה קושניר
[[:קרבות עשרת הימים]]	קרבות עשרת הימים
[[:מרדכי נאור]]	מרדכי נאור
[[:תוכנית מוריסון גריידי]]	תוכנית מוריסון גריידי
[[:חברת העובדים]]	חברת העובדים
[[:ברוך גלעדי]]	ברוך גלעדי
[[:ועידת השולחן העגול]]	ועידת השולחן העגול
[[:ועדת חקירה ממלכתית]]	ועדת חקירה ממלכתית
[[:תגובת היישוב היהודי בארץ ישראל לשואה]]	תגובת היישוב היהודי בארץ ישראל לשואה
[[:שמואל קופמן]]	שמואל קופמן
[[:קרב תל מוטילה]]	קרב תל מוטילה
[[:תוכנית פהד]]	תוכנית פהד
[[:עקורי איקרית ובירעם]]	עקורי איקרית ובירעם
[[:אתר קראוונים]]	אתר קראוונים
[[:תערוכות מגדל דוד]]	תערוכות מגדל דוד
[[:המאורעות]]	המאורעות
[[:ניל"י - יצירת הקשר עם הבריטים]]	ניל"י - יצירת הקשר עם הבריטים
[[:בווינגרד]]	בווינגרד
[[:יוסף לוי]]	יוסף לוי
[[:קטגוריה:ישראל: ועדות חקירה]]	ישראל: ועדות חקירה
[[:תחנת הרכבת סמח (צמח)]]	תחנת הרכבת סמח (צמח)
[[:נפילתה של ניל"י]]	נפילתה של ניל"י
[[:סיקור מות סטלין ב"על המשמר"]]	סיקור מות סטלין ב"על המשמר"
[[:ז'אן אלרז]]	ז'אן אלרז
[[:תוכנית לשימור אתרים]]	תוכנית לשימור אתרים
[[:יהושע מאיר גרינץ]]	יהושע מאיר גרינץ
[[:קטגוריה:יום העצמאות]]	יום העצמאות
[[:בית ליסין]]	בית ליסין
[[:ריקוד דגלים]]	ריקוד דגלים
[[:מישור חוף יהודה]]	מישור חוף יהודה
[[:ימ"ס]]	ימ"ס
[[:מוזיאון הרכב ההיסטורי]]	מוזיאון הרכב ההיסטורי
[[:החולצה הכחולה]]	החולצה הכחולה
[[:בית ראשון במולדת]]	בית ראשון במולדת
[[:רענן ויץ]]	רענן ויץ
[[:פרשת רמדיה]]	פרשת רמדיה
[[:קטגוריה:ישראל: ועדות בדיקה ממשלתיות]]	ישראל: ועדות בדיקה ממשלתיות
[[:מציאת עצמותיו של אבשלום פיינברג]]	מציאת עצמותיו של אבשלום פיינברג
[[:ראובן מס]]	ראובן מס
[[:תומאס ג'יימס וילקין]]	תומאס ג'יימס וילקין
[[:דלק (אצ"ל)]]	דלק (אצ"ל)
[[:גלגל המזלות בבתי כנסת עתיקים]]	גלגל המזלות בבתי כנסת עתיקים
[[:קזינו גלי אביב]]	קזינו גלי אביב
[[:אליעזר מרגולין]]	אליעזר מרגולין
[[:בית המוטור]]	בית המוטור
[[:טבח עישייה]]	טבח עישייה
[[:יחיאל מיכל פוחצ'בסקי]]	יחיאל מיכל פוחצ'בסקי
[[:תחנת הרכבת עפולה]]	תחנת הרכבת עפולה
[[:משה ליטוינסקי]]	משה ליטוינסקי
[[:עמנואל ולד]]	עמנואל ולד
[[:תחנת הרכבת מסעודיה]]	תחנת הרכבת מסעודיה
[[:קטגוריה:מנחם בגין]]	מנחם בגין
[[:קטגוריה:דוד בן-גוריון]]	דוד בן-גוריון
[[:רוזה כהן]]	רוזה כהן
[[:קטגוריה:שמעון פרס]]	שמעון פרס
[[:גדוד טוביה]]	גדוד טוביה
[[:ישעיהו פונדק]]	ישעיהו פונדק
[[:דו"ח ליטבק]]	דו"ח ליטבק
&rlm;[[:עליית ביתא ישראל: 1948 - 1978]]&rlm;	עליית ביתא ישראל: 1948 - 1978
[[:תימני כנרת]]	תימני כנרת
[[:הצי הישראלי]]	הצי הישראלי
[[:ההתקפה על המרכז המסחרי בממילא]]	ההתקפה על המרכז המסחרי בממילא
[[:התיישבות נתיני המעצמות בחיפה]]	התיישבות נתיני המעצמות בחיפה
[[:העלייה ממרוקו]]	העלייה ממרוקו
[[:היישוב היהודי בחברון]]	היישוב היהודי בחברון
[[:חדוה בן-ישראל]]	חדוה בן-ישראל
[[:פעולת האצ"ל בעיראק]]	פעולת האצ"ל בעיראק
[[:תחנת הרכבת שכם]]	תחנת הרכבת שכם
[[:בית לודז'יה]]	בית לודז'יה
[[:מחנה חסה]]	מחנה חסה
[[:קורינתיה (ספינה)]]	קורינתיה (ספינה)
[[:מחלקת הצילום של המושבה האמריקאית]]	מחלקת הצילום של המושבה האמריקאית
[[:קרן השמיטה]]	קרן השמיטה
[[:חיים מולכו]]	חיים מולכו
[[:נחמיה רבין]]	נחמיה רבין
[[:תחנת הרכבת בית שאן]]	תחנת הרכבת בית שאן
