ישראל - מוזיקה
[[:גבי ברלין]]	גבי ברלין
[[:יעקב הולנדר]]	יעקב הולנדר
[[:צוותא]]	צוותא
[[:מקהלת צדיקוב]]	מקהלת צדיקוב
[[:אבק (להקה)]]	אבק (להקה)
[[:בובי פנחסי]]	בובי פנחסי
[[:שמעון כהן (מוזיקאי)]]	שמעון כהן (מוזיקאי)
[[:אבי ביטר]]	אבי ביטר
[[:אלברט בגר]]	אלברט בגר
[[:התרנגולים]]	התרנגולים
[[:משפחת בנאי]]	משפחת בנאי
[[:אביבה הד]]	אביבה הד
&rlm;[[:21 (להקה)]]&rlm;	21 (להקה)
[[:להקת הנח"ל]]	להקת הנח"ל
[[:שלישיית גשר הירקון]]	שלישיית גשר הירקון
[[:שייגעצ]]	שייגעצ
[[:הילה הררי]]	הילה הררי
[[:בוטן מתוק בקרקס]]	בוטן מתוק בקרקס
[[:חמי רודנר]]	חמי רודנר
[[:יצחק קלפטר]]	יצחק קלפטר
[[:רחל שפירא]]	רחל שפירא
[[:ג'וני שועלי]]	ג'וני שועלי
[[:רעש (להקה)]]	רעש (להקה)
[[:אסף ארליך]]	אסף ארליך
[[:פונץ' (להקה)]]	פונץ' (להקה)
[[:הפה והטלפיים בחלל]]	הפה והטלפיים בחלל
[[:בין הים והביצות]]	בין הים והביצות
[[:שקט נפשי]]	שקט נפשי
[[:טוב לנו יחד]]	טוב לנו יחד
[[:פרח שחור]]	פרח שחור
[[:סימנים של חולשה]]	סימנים של חולשה
[[:חם על הירח]]	חם על הירח
&rlm;[[:1900?]]&rlm;	1900?
[[:יעל לוי (אלבום)]]	יעל לוי (אלבום)
[[:משינה (אלבום)]]	משינה (אלבום)
[[:סיפורי פוגי]]	סיפורי פוגי
[[:מי רצח את אגנתה פאלסקוג]]	מי רצח את אגנתה פאלסקוג
[[:נושאי המגבעת (אלבום)]]	נושאי המגבעת (אלבום)
[[:רדיו בלה בלה]]	רדיו בלה בלה
[[:האיש שראה הכל]]	האיש שראה הכל
[[:רשת פרפרים]]	רשת פרפרים
&rlm;[[:One Fantastic Day]]&rlm;	One Fantastic Day
[[:רועי הראבן]]	רועי הראבן
&rlm;[[:Definition]]&rlm;	Definition
[[:כוחם של מים]]	כוחם של מים
[[:רע מוכיח]]	רע מוכיח
[[:פסיכופט צעיר]]	פסיכופט צעיר
[[:פלסטלינה (אלבום)]]	פלסטלינה (אלבום)
[[:סקסטה (להקה)]]	סקסטה (להקה)
[[:תום פטרובר]]	תום פטרובר
[[:תרבות ישראלית אלטרנטיבית]]	תרבות ישראלית אלטרנטיבית
[[:אבנר גדסי]]	אבנר גדסי
[[:סטיות של פינגווינים]]	סטיות של פינגווינים
[[:נושאי המגבעת]]	נושאי המגבעת
[[:שמרית אור]]	שמרית אור
[[:יקיר אביב]]	יקיר אביב
[[:בית הבובות (להקה)]]	בית הבובות (להקה)
[[:אבטיפוס (להקה)]]	אבטיפוס (להקה)
[[:אדם (זמר)]]	אדם (זמר)
[[:טובה פירון]]	טובה פירון
[[:דן תורן]]	דן תורן
[[:מאיר הרניק]]	מאיר הרניק
[[:גזוז (להקה)]]	גזוז (להקה)
&rlm;[[:11א']]&rlm;	11א'
[[:העמותה לחקר התמותה]]	העמותה לחקר התמותה
[[:זאב נחמה]]	זאב נחמה
[[:מוני אמריליו]]	מוני אמריליו
[[:הפליינג בייבי]]	הפליינג בייבי
[[:נאהב עד שנמות]]	נאהב עד שנמות
[[:גזוז (אלבום)]]	גזוז (אלבום)
[[:בין מוסר לאופנה]]	בין מוסר לאופנה
&rlm;[[:20 הלהיטים]]&rlm;	20 הלהיטים
[[:פחות אבל כואב]]	פחות אבל כואב
[[:שם טוב לוי]]	שם טוב לוי
[[:פורדהאוז בן-ציסי]]	פורדהאוז בן-ציסי
[[:אהוד בנאי והפליטים]]	אהוד בנאי והפליטים
[[:מרחק של מטר]]	מרחק של מטר
[[:ששי קשת]]	ששי קשת
[[:שלומי שבן]]	שלומי שבן
[[:אלונה דניאל]]	אלונה דניאל
&rlm;[[:משינה 2]]&rlm;	משינה 2
[[:מאחורי הצלילים]]	מאחורי הצלילים
[[:שרה (זמרת)]]	שרה (זמרת)
[[:טאטו (להקה ישראלית)]]	טאטו (להקה ישראלית)
[[:בני דודקביץ']]	בני דודקביץ'
[[:יהואש הירשברג]]	יהואש הירשברג
[[:הצ'יזבטרון]]	הצ'יזבטרון
[[:רפי גינת]]	רפי גינת
[[:אבנר קנר]]	אבנר קנר
[[:יורם זרביב]]	יורם זרביב
[[:שמואל ברונר]]	שמואל ברונר
[[:קטגוריה:אלבומי זהב בישראל]]	אלבומי זהב בישראל
[[:ארבע-עשרה אוקטבות]]	ארבע-עשרה אוקטבות
[[:המקהלה הקאמרית רמת גן]]	המקהלה הקאמרית רמת גן
[[:שאול ביבר]]	שאול ביבר
[[:תיקי דיין]]	תיקי דיין
[[:שמחה חלד]]	שמחה חלד
[[:בועז עופרי]]	בועז עופרי
[[:מאור כהן]]	מאור כהן
[[:קטגוריה:אלבומי פלטינה בישראל]]	אלבומי פלטינה בישראל
&rlm;[[:Best music for SEX]]&rlm;	Best music for SEX
[[:שירי חג ומועד ונופל]]	שירי חג ומועד ונופל
[[:בזזז...]]	בזזז...
[[:מזל גדי (אלבום)]]	מזל גדי (אלבום)
[[:...וגלוי עיניים]]	...וגלוי עיניים
[[:קטגוריה:אלבומי רמי פורטיס]]	אלבומי רמי פורטיס
[[:קטגוריה:אלבומי ברי סחרוף]]	אלבומי ברי סחרוף
[[:לעמעלע]]	לעמעלע
[[:קטגוריה:אלבומי מאיר אריאל]]	אלבומי מאיר אריאל
[[:רם אוריון]]	רם אוריון
[[:יורם ארבל]]	יורם ארבל
[[:קטגוריה:אלבומי משינה]]	אלבומי משינה
[[:ליאור ייני]]	ליאור ייני
[[:זרעי קיץ]]	זרעי קיץ
[[:ג'נגו (זמר)]]	ג'נגו (זמר)
[[:דליה פרידלנד]]	דליה פרידלנד
[[:רישומי פחם]]	רישומי פחם
[[:ברנרד ולואיז]]	ברנרד ולואיז
[[:סוס (אלבום)]]	סוס (אלבום)
[[:אורי בשן]]	אורי בשן
[[:אורי בשן (אלבום)]]	אורי בשן (אלבום)
[[:פורטרט (להקה)]]	פורטרט (להקה)
[[:רוק מזרחי]]	רוק מזרחי
[[:שמירה אימבר]]	שמירה אימבר
[[:קטגוריה:משפחת גפן]]	משפחת גפן
[[:אלכס וייס]]	אלכס וייס
[[:שי זורניצר]]	שי זורניצר
&rlm;[[:HOMmega]]&rlm;	HOMmega
[[:ריימונד אבקסיס]]	ריימונד אבקסיס
[[:קטגוריה:אלבומי מוניקה סקס]]	אלבומי מוניקה סקס
[[:לירן נדל]]	לירן נדל
[[:ועכשיו]]	ועכשיו
[[:ניו יורק-רפיח]]	ניו יורק-רפיח
[[:טל השילוני]]	טל השילוני
[[:צדי צרפתי]]	צדי צרפתי
[[:לב קוגן]]	לב קוגן
[[:להיטון]]	להיטון
[[:ישראלים\פעולה\סקס]]	ישראלים\פעולה\סקס
[[:האצולה]]	האצולה
[[:סאבווי סאקרס]]	סאבווי סאקרס
[[:קומות קרקע ומטה]]	קומות קרקע ומטה
[[:המשאיות (אלבום)]]	המשאיות (אלבום)
[[:שמיניית ווקאל]]	שמיניית ווקאל
[[:חני ליבנה]]	חני ליבנה
[[:עמוס אטינגר]]	עמוס אטינגר
[[:מנגו (להקה)]]	מנגו (להקה)
[[:לנשום במים]]	לנשום במים
[[:דורי בן זאב]]	דורי בן זאב
[[:מתכסות]]	מתכסות
[[:משה פיש]]	משה פיש
[[:ארץ טרופית יפה]]	ארץ טרופית יפה
[[:אלכסנדר תמיר]]	אלכסנדר תמיר
[[:שי להב]]	שי להב
[[:טאבו פלוס]]	טאבו פלוס
[[:מרי לו]]	מרי לו
[[:מיקי גבריאלוב]]	מיקי גבריאלוב
[[:בדשא אצל אביגדור]]	בדשא אצל אביגדור
[[:השלושרים]]	השלושרים
[[:יסמין (אלבום)]]	יסמין (אלבום)
[[:קרוב]]	קרוב
[[:קטגוריה:אלבומי אהוד בנאי]]	אלבומי אהוד בנאי
[[:ארץ ישראל הישנה והטובה (אלבום)]]	ארץ ישראל הישנה והטובה (אלבום)
[[:חצוצרות יריחו]]	חצוצרות יריחו
[[:סע לאט]]	סע לאט
[[:מיכל טל (פסנתרנית)]]	מיכל טל (פסנתרנית)
[[:נמרוד רשף]]	נמרוד רשף
[[:יבגני יהודין]]	יבגני יהודין
[[:תזמורת קול ישראל בערבית]]	תזמורת קול ישראל בערבית
[[:ארץ ישראל הישנה והטובה חלק ב']]	ארץ ישראל הישנה והטובה חלק ב'
[[:ארץ ישראל הישנה והטובה חלק ג']]	ארץ ישראל הישנה והטובה חלק ג'
[[:משקאות חריפים]]	משקאות חריפים
[[:האהבה פנים רבות לה]]	האהבה פנים רבות לה
[[:לירון תאני]]	לירון תאני
[[:אנשים אוהבים לשיר]]	אנשים אוהבים לשיר
[[:באופן קבוע וחד פעמי]]	באופן קבוע וחד פעמי
[[:עופר נחשון]]	עופר נחשון
[[:ארץ ישראל הישנה והטובה חלק ד': משירי סשה ארגוב]]	ארץ ישראל הישנה והטובה חלק ד': משירי סשה ארגוב
[[:צ'אפלין צ'ארלי]]	צ'אפלין צ'ארלי
[[:חמוש במשקפיים]]	חמוש במשקפיים
[[:בוראן (להקה)]]	בוראן (להקה)
[[:שביר]]	שביר
[[:יושב על הגדר]]	יושב על הגדר
[[:קטגוריה:אלבומי אריק איינשטיין]]	אלבומי אריק איינשטיין
[[:ג'ירפות (להקה)]]	ג'ירפות (להקה)
[[:פסק זמן (אלבום)]]	פסק זמן (אלבום)
[[:ישיבת כינור דוד]]	ישיבת כינור דוד
[[:אוהב להיות בבית]]	אוהב להיות בבית
[[:על גבול האור]]	על גבול האור
[[:קטגוריה:אלבומי המכשפות]]	אלבומי המכשפות
[[:דידי הררי]]	דידי הררי
[[:דורית ראובני]]	דורית ראובני
[[:תמיר קליסקי]]	תמיר קליסקי
[[:האריה, היונה ותרנגולת כחולה]]	האריה, היונה ותרנגולת כחולה
[[:פאנקנשטיין]]	פאנקנשטיין
[[:קצת לקחת חזרה]]	קצת לקחת חזרה
[[:ארבע אחרי הצהריים]]	ארבע אחרי הצהריים
[[:מציאות נפרדת]]	מציאות נפרדת
[[:צועקים על אהבה]]	צועקים על אהבה
[[:שר בשבילך]]	שר בשבילך
[[:מרסדס בנד]]	מרסדס בנד
[[:יואב גינאי]]	יואב גינאי
[[:פאנק ישראלי]]	פאנק ישראלי
[[:עסק שחור]]	עסק שחור
[[:קטגוריה:אלבומי פלטינה כפולה ומעלה בישראל]]	אלבומי פלטינה כפולה ומעלה בישראל
[[:אבי אגבבה]]	אבי אגבבה
[[:אבי מטוס]]	אבי מטוס
[[:ג'קי מקייטן]]	ג'קי מקייטן
[[:אבנר חודורוב]]	אבנר חודורוב
[[:יעל לוי]]	יעל לוי
[[:דודה]]	דודה
[[:שירים (אלבום)]]	שירים (אלבום)
[[:צדוק סביר]]	צדוק סביר
[[:אריק איינשטיין ושלום חנוך בהופעה משותפת]]	אריק איינשטיין ושלום חנוך בהופעה משותפת
[[:פוזי]]	פוזי
&rlm;[[:כוורת - הופעה חיה, קיץ 1984]]&rlm;	כוורת - הופעה חיה, קיץ 1984
[[:אתה חברה שלי (אלבום)]]	אתה חברה שלי (אלבום)
[[:אילן בן שחר]]	אילן בן שחר
[[:טל יניב]]	טל יניב
[[:יש בי אהבה]]	יש בי אהבה
[[:בציר טוב]]	בציר טוב
[[:עוזי פוקס]]	עוזי פוקס
[[:כשחיכיתי לך על הספסל]]	כשחיכיתי לך על הספסל
[[:רוץ ילד]]	רוץ ילד
[[:דברים בלחש]]	דברים בלחש
[[:קח שירים]]	קח שירים
[[:ידיים למעלה]]	ידיים למעלה
[[:אוטוביוגרפיה (אלבום)]]	אוטוביוגרפיה (אלבום)
[[:דוד בוזגלו]]	דוד בוזגלו
[[:להקת הסטודנטים ירושלים]]	להקת הסטודנטים ירושלים
[[:קטגוריה:אלבומי שייגעצ]]	אלבומי שייגעצ
[[:עופר לוי]]	עופר לוי
[[:ישי לפידות]]	ישי לפידות
[[:כפיר עטיה]]	כפיר עטיה
[[:ורד קלפטר]]	ורד קלפטר
[[:רכבות]]	רכבות
[[:משוחח עם כסא]]	משוחח עם כסא
[[:זמנים מוזרים]]	זמנים מוזרים
[[:כנסיית השכל (אלבום)]]	כנסיית השכל (אלבום)
[[:מירי בן יוסף]]	מירי בן יוסף
[[:משה רסיוק]]	משה רסיוק
[[:פחד מוות]]	פחד מוות
[[:השנים היפות של גבריאל]]	השנים היפות של גבריאל
[[:אביב גדג']]	אביב גדג'
[[:אהרלה קמינסקי]]	אהרלה קמינסקי
[[:מלכת הפלקט]]	מלכת הפלקט
&rlm;[[:Collective Demise]]&rlm;	Collective Demise
[[:שמעון בוסקילה]]	שמעון בוסקילה
[[:יעל כהן]]	יעל כהן
[[:הסליל]]	הסליל
[[:ימי התום]]	ימי התום
[[:זאב טננבוים]]	זאב טננבוים
[[:להיט בראש]]	להיט בראש
[[:קטגוריה:אלבומי אביב גפן]]	אלבומי אביב גפן
[[:יעל גרמן (מוזיקאית)]]	יעל גרמן (מוזיקאית)
[[:זיו איתן]]	זיו איתן
[[:אבי פרץ (זמר)]]	אבי פרץ (זמר)
[[:אביבה אבידן]]	אביבה אבידן
[[:אמדורסקי]]	אמדורסקי
&rlm;[[:Memories of the Never Happened]]&rlm;	Memories of the Never Happened
[[:קטגוריה:אלבומי רוקפור]]	אלבומי רוקפור
[[:צוף פילוסוף]]	צוף פילוסוף
[[:שלום גד]]	שלום גד
[[:מסיבה במרתף הארמון]]	מסיבה במרתף הארמון
[[:דני קרפל (שדרן)]]	דני קרפל (שדרן)
[[:קטגוריה:אלבומי יהודה פוליקר]]	אלבומי יהודה פוליקר
[[:מאיר פניגשטיין]]	מאיר פניגשטיין
[[:כמו גדולים]]	כמו גדולים
[[:אנסמבל מיתר]]	אנסמבל מיתר
[[:סיני תור]]	סיני תור
[[:עבודה עברית (פרויקט מוזיקלי)]]	עבודה עברית (פרויקט מוזיקלי)
[[:ואג פפיאן]]	ואג פפיאן
[[:אבי ליבוביץ']]	אבי ליבוביץ'
[[:שמוליק טיאר]]	שמוליק טיאר
[[:סגיב כהן]]	סגיב כהן
[[:צבי שיסל]]	צבי שיסל
[[:אבישי אביבי]]	אבישי אביבי
&rlm;[[:A Moment of Silence]]&rlm;	A Moment of Silence
[[:דפנה לוסטיג]]	דפנה לוסטיג
[[:משירי אברהם חלפי]]	משירי אברהם חלפי
[[:הייתי פעם ילד]]	הייתי פעם ילד
[[:למה לא סיפרת לי!?]]	למה לא סיפרת לי!?
[[:תזמורת כלי הנשיפה באר שבע]]	תזמורת כלי הנשיפה באר שבע
[[:קטגוריה:אלבומי יהודית רביץ]]	אלבומי יהודית רביץ
[[:אטרף]]	אטרף
[[:עטור מצחך]]	עטור מצחך
[[:משה בקר]]	משה בקר
[[:חן צימבליסטה]]	חן צימבליסטה
[[:קטגוריה:אלבומי שלום חנוך]]	אלבומי שלום חנוך
&rlm;[[:Nationwide]]&rlm;	Nationwide
[[:קטגוריה:אלבומי גידי גוב]]	אלבומי גידי גוב
[[:הלל צורי]]	הלל צורי
&rlm;[[:מופע הארנבות של ד"ר קספר 2]]&rlm;	מופע הארנבות של ד"ר קספר 2
[[:שאנן סטריט]]	שאנן סטריט
[[:קטגוריה:אלבומי תאקט]]	אלבומי תאקט
[[:פזצטא (אלבום)]]	פזצטא (אלבום)
[[:דנה לפידות (אלבום)]]	דנה לפידות (אלבום)
[[:ג'יזל בן דור]]	ג'יזל בן דור
[[:קטגוריה:אלבומי כוורת]]	אלבומי כוורת
[[:ואלה שמות]]	ואלה שמות
[[:יגאל כרמל]]	יגאל כרמל
&rlm;[[:Naked Dance]]&rlm;	Naked Dance
[[:יגאל גורדון]]	יגאל גורדון
[[:יניב מורוזובסקי]]	יניב מורוזובסקי
[[:קרני פוסטל]]	קרני פוסטל
[[:לא יפריד דבר]]	לא יפריד דבר
[[:אתה חברה שלי (שיר)]]	אתה חברה שלי (שיר)
[[:נעמה הילמן]]	נעמה הילמן
&rlm;[[:Prey For Nothing]]&rlm;	Prey For Nothing
[[:אסף תלמודי]]	אסף תלמודי
[[:אין כניסה לפילים]]	אין כניסה לפילים
[[:ורדינה כהן]]	ורדינה כהן
[[:קטגוריה:אלבומי שלמה ארצי]]	אלבומי שלמה ארצי
&rlm;[[:רכבות 68-80-88]]&rlm;	רכבות 68-80-88
[[:זהות (אלבום)]]	זהות (אלבום)
[[:ילדודס (אלבום)]]	ילדודס (אלבום)
[[:ארץ ישראל הישנה והטובה חלק ה' - נוסטלגיה]]	ארץ ישראל הישנה והטובה חלק ה' - נוסטלגיה
