ישראל - חברה
[[:חנה לוין]]	חנה לוין
[[:צ'חצ'ח]]	צ'חצ'ח
[[:פסק דין האח והאחות]]	פסק דין האח והאחות
[[:נכות בישראל]]	נכות בישראל
[[:סל הבריאות]]	סל הבריאות
[[:קטגוריה:ישראל: תכנון ובנייה]]	ישראל: תכנון ובנייה
[[:מאיר כוכב זסלבסקי]]	מאיר כוכב זסלבסקי
[[:תוכנית מהל"ב]]	תוכנית מהל"ב
[[:בית ראשון במולדת]]	בית ראשון במולדת
[[:תנועת ציונות דתית ריאלית]]	תנועת ציונות דתית ריאלית
[[:ועידת העשוקים]]	ועידת העשוקים
[[:אמנת גביזון-מדן]]	אמנת גביזון-מדן
[[:צופי אש]]	צופי אש
[[:קטגוריה:ישראל: כנסים]]	ישראל: כנסים
[[:תוכנית ספדיה]]	תוכנית ספדיה
[[:ויקי קנפו]]	ויקי קנפו
[[:צביאל רופא]]	צביאל רופא
[[:הקליניקות המשפטיות באוניברסיטת תל אביב]]	הקליניקות המשפטיות באוניברסיטת תל אביב
[[:אסמעיל אבו סעד]]	אסמעיל אבו סעד
[[:משה שוקד]]	משה שוקד
[[:בצלאל בזק]]	בצלאל בזק
[[:הגדה קיבוצית לפסח]]	הגדה קיבוצית לפסח
[[:יעל פוזנר]]	יעל פוזנר
[[:ישראל לוין (שופט)]]	ישראל לוין (שופט)
[[:דו"ח ליטבק]]	דו"ח ליטבק
&rlm;[[:עליית ביתא ישראל: 1948 - 1978]]&rlm;	עליית ביתא ישראל: 1948 - 1978
[[:גדעון הירש]]	גדעון הירש
[[:כיפה (אתר אינטרנט)]]	כיפה (אתר אינטרנט)
[[:קרן לב"י]]	קרן לב"י
[[:רוטר.נט]]	רוטר.נט
[[:סרוגים (אתר אינטרנט)]]	סרוגים (אתר אינטרנט)
