ישראל - קולנוע
[[:סופר בוי]]	סופר בוי
[[:בומבה צור]]	בומבה צור
[[:שוד הטלפונים הגדול]]	שוד הטלפונים הגדול
[[:ספי ריבלין]]	ספי ריבלין
[[:נשיקה במצ"ח]]	נשיקה במצ"ח
&rlm;[[:אבא גנוב 2]]&rlm;	אבא גנוב 2
&rlm;[[:אבא גנוב 3]]&rlm;	אבא גנוב 3
[[:אבא גנוב]]	אבא גנוב
[[:שבלול (סרט)]]	שבלול (סרט)
[[:גידי אורשר]]	גידי אורשר
[[:חיים בוזגלו]]	חיים בוזגלו
[[:רפי בוקאי]]	רפי בוקאי
[[:שתי אצבעות מצידון]]	שתי אצבעות מצידון
[[:דב נבון]]	דב נבון
[[:ורוניקה ניקול]]	ורוניקה ניקול
[[:בית"ר פרובנס]]	בית"ר פרובנס
[[:פיטר פריי]]	פיטר פריי
[[:דני שגב]]	דני שגב
[[:בתי קולנוע בתל אביב]]	בתי קולנוע בתל אביב
[[:גיל פרנק]]	גיל פרנק
[[:עמוס כרמלי]]	עמוס כרמלי
[[:קרן הקולנוע הישראלי]]	קרן הקולנוע הישראלי
[[:עודד תאומי]]	עודד תאומי
[[:הקרן החדשה לקולנוע וטלוויזיה]]	הקרן החדשה לקולנוע וטלוויזיה
[[:בועז עופרי]]	בועז עופרי
[[:שרון עמרני]]	שרון עמרני
[[:עונג שבת (סרט)]]	עונג שבת (סרט)
[[:עמרי לוי]]	עמרי לוי
[[:שמי זרחין]]	שמי זרחין
[[:אוונטי פופולו]]	אוונטי פופולו
[[:שנת אפס]]	שנת אפס
[[:דפנה רכטר]]	דפנה רכטר
&rlm;[[:ב-72 לא הייתה מלחמה]]&rlm;	ב-72 לא הייתה מלחמה
[[:יעל ישראל]]	יעל ישראל
[[:סיגלית פוקס]]	סיגלית פוקס
[[:איתי תורג'מן]]	איתי תורג'מן
[[:עונת הדובדבנים]]	עונת הדובדבנים
[[:משהו טוטאלי]]	משהו טוטאלי
&rlm;[[:נועה בת 17]]&rlm;	נועה בת 17
[[:סימה וקנין מכשפה]]	סימה וקנין מכשפה
[[:דליה פרידלנד]]	דליה פרידלנד
[[:עיניים גדולות]]	עיניים גדולות
[[:חסמבה ונערי ההפקר]]	חסמבה ונערי ההפקר
[[:צומת וולקן (סרט)]]	צומת וולקן (סרט)
[[:אילן נוב]]	אילן נוב
[[:דרור קרן]]	דרור קרן
[[:דן תורג'מן]]	דן תורג'מן
[[:אבי אוריה]]	אבי אוריה
[[:יעל הדר]]	יעל הדר
[[:אהבה קולומביאנית]]	אהבה קולומביאנית
[[:סיפורי תל אביב]]	סיפורי תל אביב
[[:מר באום]]	מר באום
[[:יהושע ברנדשטטר]]	יהושע ברנדשטטר
[[:יעל שרוני]]	יעל שרוני
[[:ליאור חפץ]]	ליאור חפץ
[[:אביבה אהובתי]]	אביבה אהובתי
&rlm;[[:ילדי CCCP]]&rlm;	ילדי CCCP
[[:חצוצרות יריחו]]	חצוצרות יריחו
[[:שלוש אמהות]]	שלוש אמהות
[[:צחי גראד]]	צחי גראד
[[:משחק חייו]]	משחק חייו
[[:דיסטורשן (סרט)]]	דיסטורשן (סרט)
[[:רק כלבים רצים חופשי]]	רק כלבים רצים חופשי
[[:דב גליקמן]]	דב גליקמן
[[:עזית הכלבה הצנחנית (סרט)]]	עזית הכלבה הצנחנית (סרט)
[[:חיים זנאתי]]	חיים זנאתי
[[:איגור בוריסוב]]	איגור בוריסוב
[[:טוביה דובלרו]]	טוביה דובלרו
[[:מיכל בת-אדם]]	מיכל בת-אדם
[[:הפסטיבל הבין-לאומי לקולנוע גאה]]	הפסטיבל הבין-לאומי לקולנוע גאה
[[:הכוכב הכחול]]	הכוכב הכחול
[[:בוכה בגשם]]	בוכה בגשם
[[:חמש חמש]]	חמש חמש
[[:משה הדר (פומי)]]	משה הדר (פומי)
[[:צביקה קרצנר]]	צביקה קרצנר
&rlm;[[:בר 51]]&rlm;	בר 51
[[:יעוד לבנון]]	יעוד לבנון
[[:קשר הדבש]]	קשר הדבש
[[:כבלים (סרט)]]	כבלים (סרט)
[[:מעלה - בית הספר לטלוויזיה לקולנוע ולאמנויות]]	מעלה - בית הספר לטלוויזיה לקולנוע ולאמנויות
&rlm;[[:NO אקזיט]]&rlm;	NO אקזיט
[[:דוד גרינברג]]	דוד גרינברג
[[:צבי שיסל]]	צבי שיסל
[[:קולנוע שרון]]	קולנוע שרון
[[:הם היו עשרה]]	הם היו עשרה
[[:אצבע אלוהים (סרט)]]	אצבע אלוהים (סרט)
[[:מפתח הזהב]]	מפתח הזהב
[[:קולנוע אוריון]]	קולנוע אוריון
[[:מקס ומוריס]]	מקס ומוריס
[[:בן לוקח בת]]	בן לוקח בת
[[:שרון הכהן-בר]]	שרון הכהן-בר
[[:יובל ריבלין]]	יובל ריבלין
[[:אזרח אמריקאי]]	אזרח אמריקאי
