ישראל - ספורט
[[:האיגוד הישראלי לטיפוס ספורטיבי]]	האיגוד הישראלי לטיפוס ספורטיבי
[[:שמואל פרידמן]]	שמואל פרידמן
[[:האיגוד הישראלי לשחמט]]	האיגוד הישראלי לשחמט
[[:נחמיה בן אברהם]]	נחמיה בן אברהם
[[:מאיה ערוסי]]	מאיה ערוסי
[[:אלי ישראלי]]	אלי ישראלי
[[:דני ליבגוט]]	דני ליבגוט
[[:הפועל תל אביב (כדורגל נשים)]]	הפועל תל אביב (כדורגל נשים)
[[:א.כ. נס ציונה]]	א.כ. נס ציונה
[[:עדי גורדון]]	עדי גורדון
[[:אבי רצון]]	אבי רצון
[[:מודי בר-און]]	מודי בר-און
[[:מועדון ספורט רמת אפעל]]	מועדון ספורט רמת אפעל
[[:מאיר איינשטיין]]	מאיר איינשטיין
[[:מאזן גנאים]]	מאזן גנאים
[[:אריה מליניאק]]	אריה מליניאק
[[:בית"ר פרובנס]]	בית"ר פרובנס
[[:רובי שפירא]]	רובי שפירא
[[:הפועל ראשון לציון (כדוריד)]]	הפועל ראשון לציון (כדוריד)
[[:משחק השרוכים]]	משחק השרוכים
[[:הפועל רמת גן (כדוריד)]]	הפועל רמת גן (כדוריד)
[[:ברד ליף]]	ברד ליף
[[:זוהיר בהלול]]	זוהיר בהלול
&rlm;[[:ONE]]&rlm;	ONE
[[:קטגוריה:כדורגלנים ישראלים באירופה]]	כדורגלנים ישראלים באירופה
[[:קטגוריה:שוערי כדורגל ישראלים]]	שוערי כדורגל ישראלים
[[:יורם ארבל]]	יורם ארבל
[[:קטגוריה:קבוצות כדורגל נשים ישראליות]]	קבוצות כדורגל נשים ישראליות
[[:קטגוריה:קבוצות כדוריד ישראליות]]	קבוצות כדוריד ישראליות
[[:קטגוריה:קבוצות כדורעף ישראליות]]	קבוצות כדורעף ישראליות
[[:שירים ושערים]]	שירים ושערים
[[:דני עציוני]]	דני עציוני
[[:בן-ציון באייער]]	בן-ציון באייער
[[:בית"ר (אגודת ספורט)]]	בית"ר (אגודת ספורט)
[[:נדב הנפלד]]	נדב הנפלד
[[:רודי ד'אמיקו]]	רודי ד'אמיקו
[[:אליצור רמלה (כדורסל נשים)]]	אליצור רמלה (כדורסל נשים)
[[:ליגת העל בכדורסל נשים]]	ליגת העל בכדורסל נשים
[[:אבישי גורדון]]	אבישי גורדון
[[:יניב שרון]]	יניב שרון
[[:משה לרר]]	משה לרר
[[:בזה נבבה]]	בזה נבבה
[[:טולי ליבגוט]]	טולי ליבגוט
[[:תומר שטיינהאור]]	תומר שטיינהאור
[[:רון גרשנוק]]	רון גרשנוק
[[:ארז אדלשטיין]]	ארז אדלשטיין
[[:עודד שעשוע]]	עודד שעשוע
[[:יחיעם שרעבי]]	יחיעם שרעבי
[[:יאיר אזולאי]]	יאיר אזולאי
[[:כפיר אודי]]	כפיר אודי
[[:צבי רוזן]]	צבי רוזן
[[:קטגוריה:כדורסל נשים בישראל]]	כדורסל נשים בישראל
[[:מכבי עירוני נתיבות]]	מכבי עירוני נתיבות
[[:ברק פלג]]	ברק פלג
[[:אבי כהן (הירושלמי)]]	אבי כהן (הירושלמי)
[[:קטגוריה:כדורגלני גדנ"ע יהודה]]	כדורגלני גדנ"ע יהודה
[[:צ'רלטון (גוף שידור)]]	צ'רלטון (גוף שידור)
[[:קטגוריה:כדורסלניות אליצור רמלה]]	כדורסלניות אליצור רמלה
[[:מיכאל בן-חנן]]	מיכאל בן-חנן
[[:בית"ר כפר סבא]]	בית"ר כפר סבא
[[:יואב בר]]	יואב בר
[[:קטגוריה:קבוצות אוהדים בישראל]]	קבוצות אוהדים בישראל
[[:חיים צימר]]	חיים צימר
[[:קטגוריה:כדורסלניות רמת השרון]]	כדורסלניות רמת השרון
[[:קטגוריה:כדורסלנים ישראלים באירופה]]	כדורסלנים ישראלים באירופה
[[:קטגוריה:כדורסלניות ישראליות באירופה]]	כדורסלניות ישראליות באירופה
[[:קטגוריה:הפועל חולון (כדורסל)]]	הפועל חולון (כדורסל)
[[:מיקי דורסמן]]	מיקי דורסמן
[[:כריס ווטסון]]	כריס ווטסון
[[:אבי לוזון]]	אבי לוזון
[[:הפועל אשדוד (כדוריד)]]	הפועל אשדוד (כדוריד)
[[:בת-אל לזמי]]	בת-אל לזמי
&rlm;[[:ישראל באולימפיאדת הנכים טורונטו (1976)]]&rlm;	ישראל באולימפיאדת הנכים טורונטו (1976)
[[:ליאור ליפשיץ]]	ליאור ליפשיץ
[[:מכבי רמלה]]	מכבי רמלה
[[:שמואל זיסמן]]	שמואל זיסמן
[[:דן שמיר]]	דן שמיר
[[:ארון ניקסון]]	ארון ניקסון
[[:אס"א בן-גוריון באר שבע (כדוריד)]]	אס"א בן-גוריון באר שבע (כדוריד)
[[:קטגוריה:כדורסלניות אליצור מכבי נתניה]]	כדורסלניות אליצור מכבי נתניה
[[:חיים מלכה]]	חיים מלכה
[[:קטגוריה:אגודת ספורט אליצור]]	אגודת ספורט אליצור
[[:קטגוריה:כדורסלניות אס"א ירושלים]]	כדורסלניות אס"א ירושלים
[[:גרשון שפע]]	גרשון שפע
[[:הפועל צפת]]	הפועל צפת
[[:מרוץ העצמאות]]	מרוץ העצמאות
[[:קטגוריה:כדורסלניות מכבי רמת חן]]	כדורסלניות מכבי רמת חן
[[:אזרח אמריקאי]]	אזרח אמריקאי
[[:פודי חלפון]]	פודי חלפון
[[:גדי ירקוני]]	גדי ירקוני
