ישראל - משפט
[[:ליאורה גלט-ברקוביץ']]	ליאורה גלט-ברקוביץ'
[[:בג"ץ קול העם]]	בג"ץ קול העם
[[:תקנת השבים]]	תקנת השבים
[[:בג"ץ הקרקעות]]	בג"ץ הקרקעות
[[:שמחה אסף]]	שמחה אסף
[[:חוסה]]	חוסה
[[:ועדת חקירה ממלכתית]]	ועדת חקירה ממלכתית
[[:תקנות שעת חירום]]	תקנות שעת חירום
[[:חיים בסוק]]	חיים בסוק
[[:פסק דין האח והאחות]]	פסק דין האח והאחות
[[:רות בן-ישראל]]	רות בן-ישראל
[[:אברהם אלתר]]	אברהם אלתר
[[:שניאור זלמן חשין]]	שניאור זלמן חשין
[[:פסק דין ירדור]]	פסק דין ירדור
[[:קטגוריה:ישראל: ועדות חקירה]]	ישראל: ועדות חקירה
[[:קטגוריה:ישראל: תכנון ובנייה]]	ישראל: תכנון ובנייה
[[:ז'אן אלרז]]	ז'אן אלרז
[[:קטגוריה:ישראל: מורשעים שזוכו]]	ישראל: מורשעים שזוכו
[[:ורדימוס זיילר]]	ורדימוס זיילר
[[:קטגוריה:ישראל: הצעות חוק]]	ישראל: הצעות חוק
[[:צד שלישי]]	צד שלישי
[[:אמנת גביזון-מדן]]	אמנת גביזון-מדן
[[:יעקב צמח (שופט)]]	יעקב צמח (שופט)
[[:אביגדור קלגסבלד]]	אביגדור קלגסבלד
[[:קטגוריה:ישראל: ועדות בדיקה ממשלתיות]]	ישראל: ועדות בדיקה ממשלתיות
[[:ורדה אלשיך]]	ורדה אלשיך
[[:משה מרוז]]	משה מרוז
[[:בג"ץ יוסי בן-ארי נגד מנהל מינהל האוכלוסין במשרד הפנים]]	בג"ץ יוסי בן-ארי נגד מנהל מינהל האוכלוסין במשרד הפנים
[[:איתן מור (רוצח)]]	איתן מור (רוצח)
[[:קטגוריה:ישראל: דיני סביבה]]	ישראל: דיני סביבה
[[:מעוולים במשותף]]	מעוולים במשותף
[[:משטרי אחריות בדיני נזיקין]]	משטרי אחריות בדיני נזיקין
[[:משה גל]]	משה גל
[[:הקליניקות המשפטיות באוניברסיטת תל אביב]]	הקליניקות המשפטיות באוניברסיטת תל אביב
[[:אבי טבח]]	אבי טבח
[[:משה לדור]]	משה לדור
[[:ישראל לוין (שופט)]]	ישראל לוין (שופט)
[[:מעצר בישראל]]	מעצר בישראל
[[:אנה שניידר]]	אנה שניידר
[[:חיים שיין]]	חיים שיין
[[:יצחק עמית]]	יצחק עמית
[[:פסק דין הנדלס נגד קופת עם]]	פסק דין הנדלס נגד קופת עם
[[:פסק דין גנז נגד כץ]]	פסק דין גנז נגד כץ
[[:פסק דין פטרומיליו]]	פסק דין פטרומיליו
