ישראל - חינוך
[[:בית הספר לאמנויות תל אביב]]	בית הספר לאמנויות תל אביב
[[:ברוך בן יהודה]]	ברוך בן יהודה
&rlm;[[:100 מושגי יסוד]]&rlm;	100 מושגי יסוד
[[:ישיבה תיכונית]]	ישיבה תיכונית
[[:ישיבה תיכונית - תורה ומדע ליד מכון לב]]	ישיבה תיכונית - תורה ומדע ליד מכון לב
[[:משה בלייכר]]	משה בלייכר
[[:ישיבת שבי חברון]]	ישיבת שבי חברון
[[:ישיבת הקיבוץ הדתי עין צורים]]	ישיבת הקיבוץ הדתי עין צורים
[[:ישיבת ניר קריית ארבע]]	ישיבת ניר קריית ארבע
[[:ישיבת הגולן]]	ישיבת הגולן
[[:ישיבת שיח יצחק]]	ישיבת שיח יצחק
[[:ישיבת מקור חיים]]	ישיבת מקור חיים
[[:ישיבת איילת השחר]]	ישיבת איילת השחר
[[:ישיבת תורת חיים]]	ישיבת תורת חיים
[[:חיים אבירי]]	חיים אבירי
[[:ישיבה תיכונית קריית ארבע]]	ישיבה תיכונית קריית ארבע
[[:ישיבת שבות ישראל]]	ישיבת שבות ישראל
[[:ישיבת רמת גן]]	ישיבת רמת גן
[[:ישיבת בני עקיבא כפר הרואה]]	ישיבת בני עקיבא כפר הרואה
[[:ישיבת הר ברכה]]	ישיבת הר ברכה
[[:בית הספר סאדברי ירושלים]]	בית הספר סאדברי ירושלים
[[:משה רינות]]	משה רינות
[[:ישיבת נהריה]]	ישיבת נהריה
[[:ישיבת הדרום]]	ישיבת הדרום
[[:משה זילברמן]]	משה זילברמן
[[:ישיבת ברכת יוסף]]	ישיבת ברכת יוסף
[[:תיכון מקיף יהוד]]	תיכון מקיף יהוד
[[:תיכון בית ירח]]	תיכון בית ירח
[[:אשר עידן]]	אשר עידן
[[:נכות בישראל]]	נכות בישראל
[[:ישיבת מעלות התורה]]	ישיבת מעלות התורה
[[:תיכון בליך]]	תיכון בליך
[[:הצופים החלוציים]]	הצופים החלוציים
[[:יוסף עוזר]]	יוסף עוזר
[[:ישיבת קרני שומרון]]	ישיבת קרני שומרון
[[:יהושע בן-מאיר]]	יהושע בן-מאיר
[[:מרכז חינוך ליאו באק]]	מרכז חינוך ליאו באק
[[:ישיבת השומרון]]	ישיבת השומרון
[[:ישיבת נוה דקלים]]	ישיבת נוה דקלים
[[:ישיבות הקו]]	ישיבות הקו
[[:וילקומיץ]]	וילקומיץ
[[:תיכון חדש]]	תיכון חדש
[[:דוד ילין]]	דוד ילין
[[:ישיבת נתיבות יוסף]]	ישיבת נתיבות יוסף
[[:ישיבה תיכונית מצפה רמון]]	ישיבה תיכונית מצפה רמון
[[:בתי ספר לקולנוע בישראל]]	בתי ספר לקולנוע בישראל
[[:ישראל סדן (מחנך)]]	ישראל סדן (מחנך)
[[:משה צבי וקסלר]]	משה צבי וקסלר
[[:שנת שירות]]	שנת שירות
[[:אוניברסיטה משודרת]]	אוניברסיטה משודרת
[[:מקא"ם]]	מקא"ם
[[:ישיבת מדברה כעדן]]	ישיבת מדברה כעדן
[[:קווים (מכון)]]	קווים (מכון)
[[:ארץ חמדה]]	ארץ חמדה
[[:ישיבת ההסדר עכו]]	ישיבת ההסדר עכו
[[:בנימין איש-שלום]]	בנימין איש-שלום
[[:בינה (ארגון חינוכי)]]	בינה (ארגון חינוכי)
[[:אילן נוב]]	אילן נוב
[[:קונסרבטוריון]]	קונסרבטוריון
[[:בית ספר שדה]]	בית ספר שדה
[[:ישיבת אור ישראל]]	ישיבת אור ישראל
[[:קטגוריה:ירושלים: ישיבות תיכוניות]]	ירושלים: ישיבות תיכוניות
[[:ישיבת מעלה אליהו]]	ישיבת מעלה אליהו
[[:ושיננתם]]	ושיננתם
[[:ישיבת נהורא]]	ישיבת נהורא
[[:ישיבת היישוב החדש]]	ישיבת היישוב החדש
[[:מסע בני נוער לפולין]]	מסע בני נוער לפולין
[[:ישיבת שער התורה]]	ישיבת שער התורה
[[:משה אהרון בייגל]]	משה אהרון בייגל
[[:צופי אש]]	צופי אש
[[:ישיבת האידרא]]	ישיבת האידרא
[[:תלמוד תורה מורשה]]	תלמוד תורה מורשה
[[:ישיבת כינור דוד]]	ישיבת כינור דוד
[[:ישיבת סוסיא]]	ישיבת סוסיא
[[:מועדונית משפחתית]]	מועדונית משפחתית
[[:משה כהן שאולי]]	משה כהן שאולי
[[:ישיבה ציונית]]	ישיבה ציונית
[[:ישיבת תורה אור]]	ישיבת תורה אור
[[:ישיבת מאורות התורה]]	ישיבת מאורות התורה
[[:ישיבת היכל אליהו]]	ישיבת היכל אליהו
[[:מכללת אלקאסמי]]	מכללת אלקאסמי
[[:ישיבת נחלת שלמה]]	ישיבת נחלת שלמה
[[:משה קרונה]]	משה קרונה
[[:ישיבת ההסדר קריית שמונה]]	ישיבת ההסדר קריית שמונה
[[:ישיבת חכמי לובלין (בני ברק)]]	ישיבת חכמי לובלין (בני ברק)
[[:המבצע לביעור הבערות]]	המבצע לביעור הבערות
[[:מעיין שחר]]	מעיין שחר
[[:ישיבת אור אלחנן]]	ישיבת אור אלחנן
[[:מיצ"ב]]	מיצ"ב
[[:ישיבת באר יעקב]]	ישיבת באר יעקב
[[:ישיבה תיכונית חיספין]]	ישיבה תיכונית חיספין
[[:בית בירם]]	בית בירם
[[:משה דפנא]]	משה דפנא
[[:צביקה קרצנר]]	צביקה קרצנר
[[:ישיבת שיח ידידיה]]	ישיבת שיח ידידיה
[[:ישיבת כסא רחמים]]	ישיבת כסא רחמים
[[:בית הספר הניסויי אביחיל]]	בית הספר הניסויי אביחיל
[[:גבי ודבי]]	גבי ודבי
[[:ישיבת חזון עובדיה]]	ישיבת חזון עובדיה
[[:ישיבת בני חיל (שומרון)]]	ישיבת בני חיל (שומרון)
&rlm;[[:Estudios Interdisciplinarios América Latina y el Caribe]]&rlm;	Estudios Interdisciplinarios América Latina y el Caribe
[[:אורן קפלן]]	אורן קפלן
[[:ישיבת דרך השם]]	ישיבת דרך השם
[[:אריה סימון]]	אריה סימון
[[:ישיבת תפארת צבי]]	ישיבת תפארת צבי
[[:ישיבת התפוצות]]	ישיבת התפוצות
[[:יעל פוזנר]]	יעל פוזנר
[[:ישיבת שדמות נריה]]	ישיבת שדמות נריה
[[:ישיבת תקוע]]	ישיבת תקוע
[[:ישיבת קריית מלאכי]]	ישיבת קריית מלאכי
[[:יאיר דרייפוס]]	יאיר דרייפוס
[[:ישיבת תושיה]]	ישיבת תושיה
[[:ישיבת בני עקיבא גבעת שמואל]]	ישיבת בני עקיבא גבעת שמואל
[[:מאיר בוסאק]]	מאיר בוסאק
[[:אהרן מאיר מזי"א]]	אהרן מאיר מזי"א
[[:שומרי המפרץ]]	שומרי המפרץ
[[:עמותת אופנים]]	עמותת אופנים
[[:רשת הספריות העירוניות פתח תקווה]]	רשת הספריות העירוניות פתח תקווה
