משחקים
[[:משחק קופסה]]	משחק קופסה
[[:משחק ספורט]]	משחק ספורט
[[:תפסוני]]	תפסוני
[[:שבע בום]]	שבע בום
[[:חבילה הגיעה]]	חבילה הגיעה
&rlm;[[:11 (משחק)]]&rlm;	11 (משחק)
[[:טרמינל (משחק)]]	טרמינל (משחק)
[[:תשבץ פסיפס]]	תשבץ פסיפס
[[:בונוס (משחק מחשב)]]	בונוס (משחק מחשב)
[[:אנחנו יוצאים להילחם אתכם]]	אנחנו יוצאים להילחם אתכם
[[:משחק מיומנות דיבור]]	משחק מיומנות דיבור
[[:קטגוריה:משחקים שיתופיים]]	משחקים שיתופיים
[[:תשבץ מוצפן]]	תשבץ מוצפן
[[:תשבץ לבן]]	תשבץ לבן
[[:תשבץ קו]]	תשבץ קו
[[:העמותה למשחקי תפקידים בישראל]]	העמותה למשחקי תפקידים בישראל
[[:הרפתקאות במבה בממלכה הקסומה (משחק מחשב)]]	הרפתקאות במבה בממלכה הקסומה (משחק מחשב)
[[:פלנטריום כוכב כדורגל]]	פלנטריום כוכב כדורגל
[[:מספרים (משחק)]]	מספרים (משחק)
