פורטל
[[:פורטל:מתמטיקה]]	מתמטיקה
[[:פורטל:היסטוריה]]	היסטוריה
[[:פורטל:מדעי החברה]]	מדעי החברה
[[:פורטל:מדעי החלל]]	מדעי החלל
[[:פורטל:מוזיקה]]	מוזיקה
[[:פורטל:סוציולוגיה]]	סוציולוגיה
[[:פורטל:ספורט]]	ספורט
[[:פורטל:רפואה]]	רפואה
[[:פורטל:ביולוגיה]]	ביולוגיה
[[:פורטל:יהדות]]	יהדות
[[:פורטל:ישראל]]	ישראל
[[:פורטל:כימיה]]	כימיה
[[:פורטל:כלכלה]]	כלכלה
[[:פורטל:מדינות העולם]]	מדינות העולם
[[:פורטל:מדע המדינה]]	מדע המדינה
[[:פורטל:גאוגרפיה]]	גאוגרפיה
[[:פורטל:ספרות]]	ספרות
[[:פורטל:דת]]	דת
[[:פורטל:אמנות]]	אמנות
[[:פורטל:פיזיקה]]	פיזיקה
[[:פורטל:אישים]]	אישים
[[:פורטל:טכנולוגיה]]	טכנולוגיה
[[:פורטל:מחשבים]]	מחשבים
[[:פורטל:השואה]]	השואה
[[:פורטל:בעלי חיים]]	בעלי חיים
[[:פורטל:בוטניקה]]	בוטניקה
[[:פורטל:היישוב]]	היישוב
[[:פורטל:חינוך]]	חינוך
[[:פורטל:פילוסופיה]]	פילוסופיה
[[:פורטל:מסגרת מעוצבת תחתונה]]	מסגרת מעוצבת תחתונה
[[:פורטל:מסגרת מעוצבת עליונה]]	מסגרת מעוצבת עליונה
[[:פורטל:בסיס]]	בסיס
[[:פורטל:הארי פוטר]]	הארי פוטר
[[:פורטל:הבי מטאל]]	הבי מטאל
[[:פורטל:אדריכלות]]	אדריכלות
[[:פורטל:ערכים מומלצים]]	ערכים מומלצים
[[:פורטל:תחבורה]]	תחבורה
[[:פורטל:קולנוע ישראלי]]	קולנוע ישראלי
[[:פורטל:טלוויזיה]]	טלוויזיה
[[:פורטל:ברזיל]]	ברזיל
[[:פורטל:הממשל בישראל]]	הממשל בישראל
[[:פורטל:מזון]]	מזון
[[:פורטל:פורטלים]]	פורטלים
[[:פורטל:צבא]]	צבא
[[:פורטל:בלשנות]]	בלשנות
[[:פורטל:אינטרנט]]	אינטרנט
[[:פורטל:ירושלים]]	ירושלים
[[:פורטל:ארצות הברית]]	ארצות הברית
[[:פורטל:קולנוע]]	קולנוע
[[:פורטל:אסלאם]]	אסלאם
[[:פורטל:תקשורת]]	תקשורת
[[:פורטל:השפה העברית]]	השפה העברית
[[:פורטל:נצרות]]	נצרות
[[:פורטל:יוון העתיקה]]	יוון העתיקה
[[:פורטל:צה"ל]]	צה"ל
[[:פורטל:הומור]]	הומור
[[:פורטל:חוק ומשפט]]	חוק ומשפט
[[:פורטל:אוסטריה]]	אוסטריה
[[:פורטל:סין]]	סין
[[:פורטל:רכבת ישראל]]	רכבת ישראל
[[:פורטל:תל אביב-יפו]]	תל אביב-יפו
[[:פורטל:שחמט]]	שחמט
[[:פורטל:גאורגיה]]	גאורגיה
[[:פורטל:דיסני]]	דיסני
[[:פורטל:דגלים וסמלים]]	דגלים וסמלים
[[:פורטל:חיפה]]	חיפה
[[:פורטל:החי והצומח בארץ ישראל]]	החי והצומח בארץ ישראל
[[:פורטל:גוף האדם]]	גוף האדם
[[:פורטל:לונדון]]	לונדון
[[:פורטל:כדורגל]]	כדורגל
[[:פורטל:המזרח התיכון]]	המזרח התיכון
[[:פורטל:פסיכולוגיה]]	פסיכולוגיה
[[:פורטל:רומא העתיקה]]	רומא העתיקה
[[:פורטל:גאולוגיה]]	גאולוגיה
[[:פורטל:פריז]]	פריז
[[:פורטל:הממלכה המאוחדת]]	הממלכה המאוחדת
[[:פורטל:מלחמת העולם השנייה]]	מלחמת העולם השנייה
[[:פורטל:תנ"ך]]	תנ"ך
[[:פורטל:ניו יורק]]	ניו יורק
[[:פורטל:המורשת העולמית]]	המורשת העולמית
[[:פורטל:צילום]]	צילום
[[:פורטל:מוזיקה קלאסית]]	מוזיקה קלאסית
[[:פורטל:משחקים]]	משחקים
[[:פורטל:ג'אז]]	ג'אז
[[:פורטל:רומא]]	רומא
[[:פורטל:ברלין]]	ברלין
[[:פורטל:מדעי המחשב]]	מדעי המחשב
[[:פורטל:אמסטרדם]]	אמסטרדם
[[:פורטל:ברצלונה]]	ברצלונה
[[:פורטל:להט"ב]]	להט"ב
[[:פורטל:כדורסל]]	כדורסל
[[:פורטל:ארכאולוגיה של המזרח הקרוב]]	ארכאולוגיה של המזרח הקרוב
[[:פורטל:אירלנד]]	אירלנד
[[:פורטל:הלכה]]	הלכה
[[:פורטל:מלחמת העולם הראשונה]]	מלחמת העולם הראשונה
[[:פורטל:אמריקה הלטינית]]	אמריקה הלטינית
[[:פורטל:וושינגטון די. סי.]]	וושינגטון די. סי.
[[:פורטל:גרמניה]]	גרמניה
[[:פורטל:פופ]]	פופ
[[:פורטל:אמנות ישראלית]]	אמנות ישראלית
[[:פורטל:הונג קונג]]	הונג קונג
[[:פורטל:אירופה]]	אירופה
[[:פורטל:אורניתולוגיה]]	אורניתולוגיה
[[:פורטל:תולדות עם ישראל]]	תולדות עם ישראל
[[:פורטל:ביתא ישראל]]	ביתא ישראל
[[:פורטל:כדורגל ישראלי]]	כדורגל ישראלי
[[:פורטל:שבת ומועדי ישראל]]	שבת ומועדי ישראל
[[:פורטל:לוחמה אווירית]]	לוחמה אווירית
[[:פורטל:מדע בישראל]]	מדע בישראל
[[:פורטל:יונקים מימיים]]	יונקים מימיים
[[:פורטל:איראן]]	איראן
[[:פורטל:אתרי מורשת בישראל]]	אתרי מורשת בישראל
[[:פורטל:יפן]]	יפן
[[:פורטל:הספרייה הלאומית]]	הספרייה הלאומית
[[:פורטל:סנקט פטרבורג]]	סנקט פטרבורג
[[:פורטל:מוסקבה]]	מוסקבה
[[:פורטל:תנועת החסידות]]	תנועת החסידות
