צה"ל
[[:אסון השייטת]]	אסון השייטת
[[:יום הזיכרון לחללי מערכות ישראל שמקום קבורתם לא נודע]]	יום הזיכרון לחללי מערכות ישראל שמקום קבורתם לא נודע
[[:משה בר-אילן]]	משה בר-אילן
[[:סיירת שקד]]	סיירת שקד
[[:טוביה קושניר]]	טוביה קושניר
&rlm;[[:צו 8]]&rlm;	צו 8
[[:תקנות שעת חירום]]	תקנות שעת חירום
[[:חיים בסוק]]	חיים בסוק
[[:משה בר כוכבא]]	משה בר כוכבא
[[:רמי דותן]]	רמי דותן
[[:רות ירון]]	רות ירון
[[:הסדר מרכז]]	הסדר מרכז
[[:הרן בר דור]]	הרן בר דור
[[:ברוך ג'מילי]]	ברוך ג'מילי
[[:פלהיב]]	פלהיב
[[:אברהם אביגדורוב]]	אברהם אביגדורוב
[[:זרובבל הורביץ]]	זרובבל הורביץ
[[:עמנואל לנדאו]]	עמנואל לנדאו
[[:מחלקת הבקרה]]	מחלקת הבקרה
[[:תוכנית חבצלות]]	תוכנית חבצלות
[[:ארז גרשטיין]]	ארז גרשטיין
[[:ארכיון צה"ל ומערכת הביטחון]]	ארכיון צה"ל ומערכת הביטחון
[[:אבנר ברזני]]	אבנר ברזני
[[:גיל רגב]]	גיל רגב
[[:תחנת איסוף גדודית]]	תחנת איסוף גדודית
[[:בסיס טיסה (חיל האוויר הישראלי)]]	בסיס טיסה (חיל האוויר הישראלי)
[[:ז'אן אלרז]]	ז'אן אלרז
[[:מקא"ם]]	מקא"ם
[[:הטובים לטיס]]	הטובים לטיס
[[:משה מן]]	משה מן
[[:מחלקת הטיס]]	מחלקת הטיס
[[:ברוך מזרחי]]	ברוך מזרחי
[[:מסע אלונקות]]	מסע אלונקות
[[:בוחן בר-אור]]	בוחן בר-אור
[[:ספורטאי מצטיין]]	ספורטאי מצטיין
[[:ימ"ס]]	ימ"ס
[[:יאיר בורלא]]	יאיר בורלא
[[:משטרה צבאית חוקרת]]	משטרה צבאית חוקרת
[[:חוק השיפוט הצבאי]]	חוק השיפוט הצבאי
&rlm;[[:ניסיון החטיפה בע'ג'ר (2005)]]&rlm;	ניסיון החטיפה בע'ג'ר (2005)
[[:מש"ק משמעת]]	מש"ק משמעת
[[:סיירת פיקודית]]	סיירת פיקודית
[[:יהושע אשל]]	יהושע אשל
[[:משה צדוק]]	משה צדוק
[[:מתקן אדם]]	מתקן אדם
[[:מורה חיילת]]	מורה חיילת
[[:עזית הכלבה הצנחנית (סרט)]]	עזית הכלבה הצנחנית (סרט)
[[:אבא אלחנני]]	אבא אלחנני
[[:יורם יאיר]]	יורם יאיר
[[:דיר פצצות]]	דיר פצצות
[[:קורס תכנות (צה"ל)]]	קורס תכנות (צה"ל)
[[:פיורנצו קאפריוטי]]	פיורנצו קאפריוטי
[[:תעודת לוחם]]	תעודת לוחם
[[:דין משמעתי בצה"ל]]	דין משמעתי בצה"ל
[[:תברואן (צה"ל)]]	תברואן (צה"ל)
[[:משה ליפל]]	משה ליפל
[[:טוביה רביב]]	טוביה רביב
[[:משה הדר (פומי)]]	משה הדר (פומי)
[[:מדריך נוער (צה"ל)]]	מדריך נוער (צה"ל)
[[:ישראל מהרי"ק]]	ישראל מהרי"ק
[[:יחידת אופק]]	יחידת אופק
[[:כן מה?!]]	כן מה?!
[[:שמואל ארד]]	שמואל ארד
[[:בטאון חיל האוויר]]	בטאון חיל האוויר
[[:שמעון נוה]]	שמעון נוה
[[:עמנואל ולד]]	עמנואל ולד
[[:קטגוריה:יחידות צה"ל מעוטרות]]	יחידות צה"ל מעוטרות
[[:משה פלד (אלוף)]]	משה פלד (אלוף)
[[:המכללה הבין-זרועית לפיקוד ולמטה]]	המכללה הבין-זרועית לפיקוד ולמטה
[[:גדוד טוביה]]	גדוד טוביה
[[:מונטי גרין]]	מונטי גרין
[[:עדים במדים]]	עדים במדים
[[:אפרים לפיד]]	אפרים לפיד
[[:גיוס ציוד (ישראל)]]	גיוס ציוד (ישראל)
&rlm;[[:יחידה 30]]&rlm;	יחידה 30
[[:ישראל ליברטובסקי]]	ישראל ליברטובסקי
[[:כלנית (פגז)]]	כלנית (פגז)
[[:יצחק יעקב]]	יצחק יעקב
[[:מבצע שנונית]]	מבצע שנונית
[[:קרן לב"י]]	קרן לב"י
[[:פזצט"א]]	פזצט"א
[[:מוזיאון בתי האוסף לתולדות צה"ל]]	מוזיאון בתי האוסף לתולדות צה"ל
[[:עגה צה"לית]]	עגה צה"לית
[[:אלי אמיתי]]	אלי אמיתי
[[:אילן מלכא]]	אילן מלכא
[[:גדעון אלרום]]	גדעון אלרום
[[:תגי כובע בצה"ל]]	תגי כובע בצה"ל
[[:פלוגת רפואה חטיבתית]]	פלוגת רפואה חטיבתית
[[:אריק מורן]]	אריק מורן
