ציונות
[[:ציונות מדינית]]	ציונות מדינית
[[:ציונות מעשית]]	ציונות מעשית
[[:ציונות סינתטית]]	ציונות סינתטית
[[:ציוני ציון]]	ציוני ציון
[[:ארגונים צבאיים לפני קום המדינה]]	ארגונים צבאיים לפני קום המדינה
[[:משה בר-אילן]]	משה בר-אילן
[[:משה בילינסון]]	משה בילינסון
[[:סליק]]	סליק
[[:ישראל רוגוזין]]	ישראל רוגוזין
[[:אברהם איכר]]	אברהם איכר
[[:תוכנית אל עריש]]	תוכנית אל עריש
[[:אחוזת בית]]	אחוזת בית
[[:ברוך גלעדי]]	ברוך גלעדי
[[:מנחם שינקין]]	מנחם שינקין
[[:כ"ג יורדי הסירה]]	כ"ג יורדי הסירה
[[:פולמוס גדרה]]	פולמוס גדרה
[[:חיים בסוק]]	חיים בסוק
[[:יודופוביה]]	יודופוביה
[[:יד יערי]]	יד יערי
[[:אביעזר זיגמונד גסטטנר]]	אביעזר זיגמונד גסטטנר
[[:ארתור מנחם הנטקה]]	ארתור מנחם הנטקה
[[:הרן בר דור]]	הרן בר דור
[[:ועידת הלסינגפורס]]	ועידת הלסינגפורס
[[:משה יוסף גליקסון]]	משה יוסף גליקסון
[[:חוות כנרת]]	חוות כנרת
[[:אריה שנארי]]	אריה שנארי
[[:ניל"י - יצירת הקשר עם הבריטים]]	ניל"י - יצירת הקשר עם הבריטים
[[:רבקה אהרנסון]]	רבקה אהרנסון
[[:שמעון רוקח]]	שמעון רוקח
[[:מבצע יכין]]	מבצע יכין
[[:עיתונות ציונית ברומניה]]	עיתונות ציונית ברומניה
[[:נפילתה של ניל"י]]	נפילתה של ניל"י
[[:יחזקאל חנקין]]	יחזקאל חנקין
[[:ישראל גלעדי]]	ישראל גלעדי
[[:מישור חוף יהודה]]	מישור חוף יהודה
[[:בית ראשון במולדת]]	בית ראשון במולדת
[[:סרטיפיקט]]	סרטיפיקט
[[:מנחם מנדל דוליצקי]]	מנחם מנדל דוליצקי
[[:רענן ויץ]]	רענן ויץ
[[:ליברטאד]]	ליברטאד
[[:מציאת עצמותיו של אבשלום פיינברג]]	מציאת עצמותיו של אבשלום פיינברג
[[:משה צדוק]]	משה צדוק
[[:דב פטישי]]	דב פטישי
[[:משה קרונה]]	משה קרונה
[[:משה מרק]]	משה מרק
[[:ישראל קלוזנר]]	ישראל קלוזנר
[[:יעקב סיקא אהרוני]]	יעקב סיקא אהרוני
[[:משה זעירי]]	משה זעירי
[[:טוביה רביב]]	טוביה רביב
[[:בצלאל בזק]]	בצלאל בזק
[[:קטגוריה:מנחם בגין]]	מנחם בגין
[[:רוזה כהן]]	רוזה כהן
[[:הגדה קיבוצית לפסח]]	הגדה קיבוצית לפסח
[[:דו"ח ליטבק]]	דו"ח ליטבק
[[:יהודה גור]]	יהודה גור
[[:תימני כנרת]]	תימני כנרת
[[:תמונת פגישת הרצל עם קיסר גרמניה]]	תמונת פגישת הרצל עם קיסר גרמניה
[[:נחמיה רבין]]	נחמיה רבין
