קומיקס ופנזינים
[[:הגולם (קומיקס)]]	הגולם (קומיקס)
&rlm;[[:Plan B]]&rlm;	Plan B
[[:אוק"י]]	אוק"י
[[:סטיות של פינגווינים]]	סטיות של פינגווינים
[[:אמיתי סנדי]]	אמיתי סנדי
[[:הוברט הוברט]]	הוברט הוברט
[[:פרויקט ספרות זולה]]	פרויקט ספרות זולה
[[:גלנדון ואיזבלה]]	גלנדון ואיזבלה
[[:יוסף (דמות)]]	יוסף (דמות)
[[:הברווז (דמות)]]	הברווז (דמות)
[[:שתיקת הברווז]]	שתיקת הברווז
&rlm;[[:חבורת A4]]&rlm;	חבורת A4
[[:חבורת החור]]	חבורת החור
[[:אדירי התכלת]]	אדירי התכלת
[[:אביב אור]]	אביב אור
[[:ארינאה]]	ארינאה
[[:פיצריה קמיקזה]]	פיצריה קמיקזה
[[:אודי (קומיקס)]]	אודי (קומיקס)
[[:נמרוד רשף]]	נמרוד רשף
[[:דניאלה לונדון דקל]]	דניאלה לונדון דקל
[[:ג'קי]]	ג'קי
[[:דדליין (קומיקס)]]	דדליין (קומיקס)
[[:זבנגלה]]	זבנגלה
[[:נעם נדב]]	נעם נדב
[[:המוזיאון הישראלי לקריקטורה ולקומיקס]]	המוזיאון הישראלי לקריקטורה ולקומיקס
&rlm;[[:איל B]]&rlm;	איל B
[[:סופר שלומפר]]	סופר שלומפר
[[:יתומי הסערה (קומיקס)]]	יתומי הסערה (קומיקס)
[[:ירמי פינקוס]]	ירמי פינקוס
[[:גלעד סליקטר]]	גלעד סליקטר
[[:סטודיו קומיקום]]	סטודיו קומיקום
[[:בבא (קומיקס)]]	בבא (קומיקס)
[[:גיא מורד]]	גיא מורד
[[:איציק רנרט]]	איציק רנרט
