רבנים
[[:מנחם פליקס]]	מנחם פליקס
[[:משה בלייכר]]	משה בלייכר
[[:שמחה אסף]]	שמחה אסף
[[:שמעון אגסי]]	שמעון אגסי
[[:סאסי מעתוק הכהן יהונתן]]	סאסי מעתוק הכהן יהונתן
[[:שמעון גרשון רוזנברג]]	שמעון גרשון רוזנברג
[[:שמואל טל]]	שמואל טל
[[:משה אביגדור עמיאל]]	משה אביגדור עמיאל
[[:שמואל אבידור הכהן]]	שמואל אבידור הכהן
[[:מאיר יהודה גץ]]	מאיר יהודה גץ
[[:אליעזר מלמד]]	אליעזר מלמד
[[:רחל בת כלבא שבוע]]	רחל בת כלבא שבוע
[[:משה צוריאל]]	משה צוריאל
[[:משה יהודה שלזינגר]]	משה יהודה שלזינגר
[[:תארים רבניים]]	תארים רבניים
[[:משה יהודא לייב לנדא]]	משה יהודא לייב לנדא
[[:יעקב לנדא]]	יעקב לנדא
[[:רבי יצחק נפחא]]	רבי יצחק נפחא
[[:יהושע בן-מאיר]]	יהושע בן-מאיר
[[:שמואל יהודה הירש]]	שמואל יהודה הירש
[[:משה יהושע הגר]]	משה יהושע הגר
[[:אברהם אהרן בורשטיין]]	אברהם אהרן בורשטיין
[[:מנשה מאיליה]]	מנשה מאיליה
[[:ישראל יפה]]	ישראל יפה
[[:משה צבי וקסלר]]	משה צבי וקסלר
[[:ישראל דן טאוב]]	ישראל דן טאוב
[[:אלחנן בן יצחק]]	אלחנן בן יצחק
[[:אברהם שלמה זלמן צורף]]	אברהם שלמה זלמן צורף
[[:דרור פיקסלר]]	דרור פיקסלר
[[:ישראל מזמושץ']]	ישראל מזמושץ'
[[:אברהם אלטר פולק]]	אברהם אלטר פולק
[[:אברהם אלימלך פרלוב]]	אברהם אלימלך פרלוב
[[:ישראל עוזרי]]	ישראל עוזרי
[[:משה הגר]]	משה הגר
[[:שלום מויאל]]	שלום מויאל
[[:יציאת האדמו"ר מבעלז מהונגריה]]	יציאת האדמו"ר מבעלז מהונגריה
[[:אמנון בזק]]	אמנון בזק
[[:מאיר ליכטנשטיין]]	מאיר ליכטנשטיין
[[:אלישיב קנוהל]]	אלישיב קנוהל
[[:משה כהן שאולי]]	משה כהן שאולי
[[:ישראל קושטא]]	ישראל קושטא
[[:משה מטראצ'ינה]]	משה מטראצ'ינה
[[:משה דוד ואלי]]	משה דוד ואלי
[[:ישראל גרוסמן]]	ישראל גרוסמן
[[:משה חסקין]]	משה חסקין
[[:משה רבקש]]	משה רבקש
[[:משולם איגרא]]	משולם איגרא
[[:דוד בן עמרם עדני]]	דוד בן עמרם עדני
[[:ישראל פורת]]	ישראל פורת
[[:מתיאש אייסלר]]	מתיאש אייסלר
[[:יצחק הלוי]]	יצחק הלוי
[[:משה מרדכי פרבשטיין]]	משה מרדכי פרבשטיין
[[:משה יחיאל הלוי אפשטיין]]	משה יחיאל הלוי אפשטיין
[[:משה קאשטרו]]	משה קאשטרו
[[:יונה שטנצל]]	יונה שטנצל
[[:שבתאי בן חיים]]	שבתאי בן חיים
[[:משולם ראטה]]	משולם ראטה
[[:משה לנדאו]]	משה לנדאו
[[:משה ריבלין]]	משה ריבלין
[[:יצחק ברזאני]]	יצחק ברזאני
[[:בבכא יעקב]]	בבכא יעקב
[[:חיים טירר]]	חיים טירר
[[:משה שפירא (רב)]]	משה שפירא (רב)
[[:יצחק נח]]	יצחק נח
&rlm;[[:יעקב בירב (המאה ה-18)]]&rlm;	יעקב בירב (המאה ה-18)
[[:יצחק עמדי]]	יצחק עמדי
[[:מאיר פוזנר]]	מאיר פוזנר
[[:יוסף שרביט]]	יוסף שרביט
[[:יאיר דרייפוס]]	יאיר דרייפוס
[[:מנחם נחום פרידמן (השני)]]	מנחם נחום פרידמן (השני)
[[:גרשון אדלשטיין]]	גרשון אדלשטיין
[[:מרדכי איפרגן]]	מרדכי איפרגן
[[:כיפה (אתר אינטרנט)]]	כיפה (אתר אינטרנט)
[[:שלום דובער שניאורסון (מרציצה)]]	שלום דובער שניאורסון (מרציצה)
[[:יהושע מאמאן]]	יהושע מאמאן
[[:שלמה זלמן אהרנרייך]]	שלמה זלמן אהרנרייך
[[:יצחק אביגדור אורנשטיין]]	יצחק אביגדור אורנשטיין
[[:משה מרדכי הלוי שולזינגר]]	משה מרדכי הלוי שולזינגר
[[:צבי מרקוביץ]]	צבי מרקוביץ
[[:מאיר אשכנזי]]	מאיר אשכנזי
[[:דב הכהן קוק]]	דב הכהן קוק
[[:סרוגים (אתר אינטרנט)]]	סרוגים (אתר אינטרנט)
