רכבת ישראל
[[:תחנת הרכבת סמח (צמח)]]	תחנת הרכבת סמח (צמח)
[[:קטגוריה:ישראל: תחנות רכבת עתידיות]]	ישראל: תחנות רכבת עתידיות
[[:קטגוריה:ישראל: תחנות רכבת היסטוריות]]	ישראל: תחנות רכבת היסטוריות
[[:תחנת הרכבת חדרה מזרח]]	תחנת הרכבת חדרה מזרח
[[:תוכנית החומש של רכבת ישראל]]	תוכנית החומש של רכבת ישראל
[[:תחנת הרכבת חיפה בית המכס]]	תחנת הרכבת חיפה בית המכס
[[:תחנת הרכבת לב המפרץ מזרח]]	תחנת הרכבת לב המפרץ מזרח
[[:תחנת הרכבת שפירים]]	תחנת הרכבת שפירים
[[:תחנת הרכבת הטורקית (באר שבע)]]	תחנת הרכבת הטורקית (באר שבע)
[[:תחנת הרכבת אופקים]]	תחנת הרכבת אופקים
[[:תחנת הרכבת קריית מלאכי]]	תחנת הרכבת קריית מלאכי
[[:תחנת הרכבת עפולה]]	תחנת הרכבת עפולה
[[:תחנת הרכבת נתיבות]]	תחנת הרכבת נתיבות
[[:תחנת הרכבת דיר סניד]]	תחנת הרכבת דיר סניד
[[:תחנת הרכבת מסעודיה]]	תחנת הרכבת מסעודיה
[[:תחנת הרכבת נען]]	תחנת הרכבת נען
[[:תחנת הרכבת רינתיה]]	תחנת הרכבת רינתיה
[[:תחנת הרכבת כפר ג'יניס]]	תחנת הרכבת כפר ג'יניס
[[:תחנת הרכבת אחיטוב]]	תחנת הרכבת אחיטוב
[[:תחנת הרכבת שכם]]	תחנת הרכבת שכם
[[:תחנת הרכבת שדרות]]	תחנת הרכבת שדרות
[[:תחנת הרכבת בית שאן]]	תחנת הרכבת בית שאן
