תולדות עם ישראל
[[:אנטישמיות בגרמניה]]	אנטישמיות בגרמניה
[[:גדוד נהגי הפרדות]]	גדוד נהגי הפרדות
[[:נגד פלאקוס והמשלחת לגאיוס]]	נגד פלאקוס והמשלחת לגאיוס
[[:יודופוביה]]	יודופוביה
[[:שניים וחצי השבטים]]	שניים וחצי השבטים
[[:צבא בר כוכבא]]	צבא בר כוכבא
[[:איזדדואר]]	איזדדואר
[[:פילוג ממלכת ישראל המאוחדת]]	פילוג ממלכת ישראל המאוחדת
[[:פרשת שמעון אבלס]]	פרשת שמעון אבלס
[[:קטגוריה:קצרמר השואה]]	קצרמר השואה
[[:משכילים מוקדמים]]	משכילים מוקדמים
[[:קטגוריה:משכילים מוקדמים]]	משכילים מוקדמים
[[:הוועד הארצי של ארגוני נוער יהודיים]]	הוועד הארצי של ארגוני נוער יהודיים
[[:יציאת האדמו"ר מבעלז מהונגריה]]	יציאת האדמו"ר מבעלז מהונגריה
[[:גראנה (תוניסיה)]]	גראנה (תוניסיה)
[[:תקופת התחייה]]	תקופת התחייה
[[:מסיבה (בית המקדש)]]	מסיבה (בית המקדש)
[[:תרביץ]]	תרביץ
[[:דוד גורדון]]	דוד גורדון
