תל אביב
[[:זמן לאמנות]]	זמן לאמנות
[[:תוכנית גדס]]	תוכנית גדס
[[:רחוב שינקין]]	רחוב שינקין
[[:אחוזת בית]]	אחוזת בית
[[:חיים בסוק]]	חיים בסוק
[[:כסית]]	כסית
[[:משה אביגדור עמיאל]]	משה אביגדור עמיאל
[[:יריד המזרח]]	יריד המזרח
[[:קטגוריה:רמת אביב]]	רמת אביב
[[:שמעון רוקח]]	שמעון רוקח
[[:בתי קולנוע בתל אביב]]	בתי קולנוע בתל אביב
[[:אריה אלחנני]]	אריה אלחנני
[[:מנחם כהן (אדריכל)]]	מנחם כהן (אדריכל)
[[:הסינרמה]]	הסינרמה
[[:קאמל קומדי קלאב]]	קאמל קומדי קלאב
[[:נחלת בנימין]]	נחלת בנימין
[[:שוק הפשפשים (יפו)]]	שוק הפשפשים (יפו)
[[:שוק בצלאל]]	שוק בצלאל
[[:שדרות נורדאו]]	שדרות נורדאו
[[:שכונת חצר]]	שכונת חצר
[[:אבא אלחנני]]	אבא אלחנני
[[:יעקב יער]]	יעקב יער
[[:אהרן שלוש]]	אהרן שלוש
[[:גן הגת]]	גן הגת
[[:בית עיריית תל אביב-יפו]]	בית עיריית תל אביב-יפו
[[:שדרות שאול המלך (תל אביב)]]	שדרות שאול המלך (תל אביב)
[[:ביצרון (שכונה)]]	ביצרון (שכונה)
[[:רוזה כהן]]	רוזה כהן
[[:עיריית תל אביב-יפו]]	עיריית תל אביב-יפו
[[:נורדיה (שכונה)]]	נורדיה (שכונה)
[[:ישראל פיינברג]]	ישראל פיינברג
[[:נתן וולוך]]	נתן וולוך
[[:הגרלת המגרשים לאחוזת בית]]	הגרלת המגרשים לאחוזת בית
[[:מרכז מסחרי (תל אביב)]]	מרכז מסחרי (תל אביב)
[[:קולנוע גת]]	קולנוע גת
[[:מוסך דן]]	מוסך דן
[[:בית העיר תל אביב-יפו]]	בית העיר תל אביב-יפו
[[:נחמיה רבין]]	נחמיה רבין
